Number of words in combined.txt: 12972
Number of answer words: 2309
Solution for trace: trace
Solution for humph: trace BBBBB soily BBBBB humph
Solution for funny: trace BBBBB soily BBBBG dogma BBBBB funny
Solution for puppy: trace BBBBB soily BBBBG dogma BBBBB funny BGBBG puppy
Solution for hunky: trace BBBBB soily BBBBG dogma BBBBB funny BGGBG hunky
Solution for bunny: trace BBBBB soily BBBBG dogma BBBBB funny BGGGG bunny
Solution for fuzzy: trace BBBBB soily BBBBG dogma BBBBB funny GGBBG fuzzy
Solution for funky: trace BBBBB soily BBBBG dogma BBBBB funny GGGBG funky
Solution for puffy: trace BBBBB soily BBBBG dogma BBBBB funny YGBBG puffy
Solution for mummy: trace BBBBB soily BBBBG dogma BBBGB mummy
Solution for jumpy: trace BBBBB soily BBBBG dogma BBBYB jumpy
Solution for buggy: trace BBBBB soily BBBBG dogma BBGBB buggy
Solution for pygmy: trace BBBBB soily BBBBG dogma BBGGB pygmy
Solution for guppy: trace BBBBB soily BBBBG dogma BBYBB guppy
Solution for gummy: trace BBBBB soily BBBBG dogma BBYGB gummy
Solution for dummy: trace BBBBB soily BBBBG dogma GBBGB dummy
Solution for dumpy: trace BBBBB soily BBBBG dogma GBBYB dumpy
Solution for buddy: trace BBBBB soily BBBBG dogma YBBBB buddy
Solution for muddy: trace BBBBB soily BBBBG dogma YBBYB muddy
Solution for pudgy: trace BBBBB soily BBBBG dogma YBYBB pudgy
Solution for nymph: trace BBBBB soily BBBBY nymph
Solution for fully: trace BBBBB soily BBBGG gybed BYBBB fully
Solution for dully: trace BBBBB soily BBBGG gybed BYBBY dully
Solution for bully: trace BBBBB soily BBBGG gybed BYYBB bully
Solution for gully: trace BBBBB soily BBBGG gybed GYBBB gully
Solution for flunk: trace BBBBB soily BBBYB flunk
Solution for plump: trace BBBBB soily BBBYB flunk BGGBB plump
Solution for plumb: trace BBBBB soily BBBYB flunk BGGBB plump GGGGB plumb
Solution for plunk: trace BBBBB soily BBBYB flunk BGGGG plunk
Solution for fluff: trace BBBBB soily BBBYB flunk GGGBB fluff
Solution for flung: trace BBBBB soily BBBYB flunk GGGGB flung
Solution for bluff: trace BBBBB soily BBBYB flunk YGGBB bluff
Solution for pulpy: arace BBBBB soily BBBYG pulpy
Solution for bulky: trace BBBBB soily BBBYG pulpy BGGBG bulky
Solution for lumpy: trace BBBBB soily BBBYG pulpy BGYGG lumpy
Solution for lymph: trace BBBBB soily BBBYY lymph
Solution for glyph: trace BBBBB soily BBBYY lymph YYBGG glyph
Solution for whiff: trace BBBBB soily BBGBB whiff
Solution for whiny: trace BBBBB soily BBGBG whiny
Solution for unify: trace BBBBB soily BBGBG whiny BBGYG unify
Solution for vying: trace BBBBB soily BBGBY vying
Solution for dying: trace BBBBB soily BBGBY vying BGGGG dying
Solution for guild: trace BBBBB soily BBGGB guild
Solution for quill: trace BBBBB soily BBGGB guild BGGGB quill
Solution for build: trace BBBBB soily BBGGB guild BGGGG build
Solution for blink: trace BBBBB soily BBGYB blink
Solution for fling: trace BBBBB soily BBGYB blink BGGGB fling
Solution for blimp: trace BBBBB soily BBGYB blink GGGBB blimp
Solution for blind: trace BBBBB soily BBGYB blink GGGGB blind
Solution for lying: trace BBBBB soily BBGYY lying
Solution for unzip: trace BBBBB soily BBYBB unzip
Solution for vivid: trace BBBBB soily BBYBB unzip BBBGB vivid
Solution for minim: trace BBBBB soily BBYBB unzip BYBGB minim
Solution for undid: trace BBBBB soily BBYBB unzip GGBGB undid
Solution for humid: trace BBBBB soily BBYBB unzip YBBGB humid
Solution for fungi: trace BBBBB soily BBYBB unzip YYBYB fungi
Solution for jiffy: trace BBBBB soily BBYBG pownd BBBBB jiffy
Solution for fizzy: trace BBBBB soily BBYBG pownd BBBBB jiffy BGYBG fizzy
Solution for giddy: trace BBBBB soily BBYBG pownd BBBBY giddy
Solution for biddy: trace BBBBB soily BBYBG pownd BBBBY giddy BGGGG biddy
Solution for dizzy: trace BBBBB soily BBYBG pownd BBBBY giddy BGYBG dizzy
Solution for ninny: trace BBBBB soily BBYBG pownd BBBGB ninny
Solution for kinky: trace BBBBB soily BBYBG pownd BBBYB kinky
Solution for dingy: trace BBBBB soily BBYBG pownd BBBYY dingy
Solution for windy: trace BBBBB soily BBYBG pownd BBYYY windy
Solution for piggy: trace BBBBB soily BBYBG pownd GBBBB piggy
Solution for pinky: trace BBBBB soily BBYBG pownd GBBYB pinky
Solution for hippy: trace BBBBB soily BBYBG pownd YBBBB hippy
Solution for wimpy: trace BBBBB soily BBYBG pownd YBYBB wimpy
Solution for billy: trace BBBBB soily BBYGG wyled BYGBB whoof BBBBB billy
Solution for filly: trace BBBBB soily BBYGG wyled BYGBB whoof BBBBY filly
Solution for hilly: trace BBBBB soily BBYGG wyled BYGBB whoof BYBBB hilly
Solution for dilly: trace BBBBB soily BBYGG wyled BYGBY dilly
Solution for imply: trace BBBBB soily BBYGG wyled BYYBB imply
Solution for dimly: trace BBBBB soily BBYGG wyled BYYBY dimly
Solution for willy: trace BBBBB soily BBYGG wyled GYGBB willy
Solution for idyll: trace BBBBB soily BBYGY idyll
Solution for vigil: trace BBBBB soily BBYYB vigil
Solution for pupil: trace BBBBB soily BBYYB vigil BBBGG pupil
Solution for fluid: trace BBBBB soily BBYYB vigil BBBGY fluid
Solution for lipid: trace BBBBB soily BBYYB vigil BGBGY lipid
Solution for livid: trace BBBBB soily BBYYB vigil YGBGY livid
Solution for milky: trace BBBBB soily BBYYG milky
Solution for filmy: trace BBBBB soily BBYYG milky YGGBG filmy
Solution for vinyl: trace BBBBB soily BBYYY vinyl
Solution for wound: trace BBBBB soily BGBBB bumph BYBBB wound
Solution for found: trace BBBBB soily BGBBB bumph BYBBB wound BGGGG found
Solution for dough: trace BBBBB soily BGBBB bumph BYBBG dough
Solution for hound: trace BBBBB soily BGBBB bumph BYBBY hound
Solution for pound: trace BBBBB soily BGBBB bumph BYBYB pound
Solution for mound: trace BBBBB soily BGBBB bumph BYYBB mound
Solution for bongo: trace BBBBB soily BGBBB bumph GBBBB bongo
Solution for bound: trace BBBBB soily BGBBB bumph GYBBB bound
Solution for bough: trace BBBBB soily BGBBB bumph GYBBG bough
Solution for hobby: trace BBBBB soily BGBBG gowds BGBBB hobby
Solution for poppy: trace BBBBB soily BGBBG gowds BGBBB hobby BGBBG poppy
Solution for bobby: trace BBBBB soily BGBBG gowds BGBBB hobby BGGGG bobby
Solution for boozy: trace BBBBB soily BGBBG gowds BGBBB hobby BGYBG boozy
Solution for booby: trace BBBBB soily BGBBG gowds BGBBB hobby BGYGG booby
Solution for moody: trace BBBBB soily BGBBG gowds BGBGB moody
Solution for howdy: trace BBBBB soily BGBBG gowds BGGGB howdy
Solution for dowdy: trace BBBBB soily BGBBG gowds BGGGB howdy BGGGG dowdy
Solution for downy: trace BBBBB soily BGBBG gowds BGGYB downy
Solution for woozy: trace BBBBB soily BGBBG gowds BGYBB woozy
Solution for woody: trace BBBBB soily BGBBG gowds BGYGB woody
Solution for goofy: trace BBBBB soily BGBBG gowds GGBBB goofy
Solution for goody: trace BBBBB soily BGBBG gowds GGBGB goody
Solution for foggy: trace BBBBB soily BGBBG gowds YGBBB foggy
Solution for dodgy: trace BBBBB soily BGBBG gowds YGBYB dodgy
Solution for young: trace BBBBB soily BGBBY young
Solution for would: trace BBBBB soily BGBGB would
Solution for jolly: trace BBBBB soily BGBGG wyled BYGBB fight BBBBB jolly
Solution for holly: trace BBBBB soily BGBGG wyled BYGBB fight BBBYB holly
Solution for golly: trace BBBBB soily BGBGG wyled BYGBB fight BBYBB golly
Solution for folly: trace BBBBB soily BGBGG wyled BYGBB fight GBBBB folly
Solution for dolly: trace BBBBB soily BGBGG wyled BYGBY dolly
Solution for nobly: trace BBBBB soily BGBGG wyled BYYBB nobly
Solution for godly: trace BBBBB soily BGBGG wyled BYYBY godly
Solution for wooly: trace BBBBB soily BGBGG wyled GYYBB wooly
Solution for lowly: trace BBBBB soily BGBGG wyled YYYBB lowly
Solution for mogul: trace BBBBB soily BGBYB mogul
Solution for loopy: trace BBBBB soily BGBYG loopy
Solution for lobby: trace BBBBB soily BGBYG loopy GGBBG lobby
Solution for moldy: trace BBBBB soily BGBYG loopy YGBBG moldy
Solution for polyp: trace BBBBB soily BGBYY polyp
Solution for going: trace BBBBB soily BGGBB going
Solution for doing: trace BBBBB soily BGGBB going BGGGG doing
Solution for login: trace BBBBB soily BGYYB login
Solution for folio: trace BBBBB soily BGYYB login YGBGB folio
Solution for buxom: trace BBBBB soily BYBBB wagon BBBGB buxom
Solution for jumbo: trace BBBBB soily BYBBB wagon BBBYB jumbo
Solution for gumbo: trace BBBBB soily BYBBB wagon BBYYB gumbo
Solution for whoop: trace BBBBB soily BYBBB wagon GBBGB whoop
Solution for known: trace BBBBB soily BYBBB wagon YBBYG known
Solution for phony: trace BBBBB soily BYBBG phony
Solution for knoll: trace BBBBB soily BYBGB knoll
Solution for oddly: trace BBBBB soily BYBGG oddly
Solution for blood: trace BBBBB soily BYBYB blood
Solution for flown: trace BBBBB soily BYBYB blood BGGBB flown
Solution for gloom: trace BBBBB soily BYBYB blood BGGGB gloom
Solution for flood: trace BBBBB soily BYBYB blood BGGGG flood
Solution for ghoul: trace BBBBB soily BYBYB blood BYGBB ghoul
Solution for blown: trace BBBBB soily BYBYB blood GGGBB blown
Solution for blond: trace BBBBB soily BYBYB blood GGGBG blond
Solution for bloom: trace BBBBB soily BYBYB blood GGGGB bloom
Solution for nylon: trace BBBBB soily BYBYY nylon
Solution for union: trace BBBBB soily BYGBB union
Solution for idiom: trace BBBBB soily BYGBB union BBGGB idiom
Solution for onion: trace BBBBB soily BYGBB union BGGGG onion
Solution for owing: trace BBBBB soily BYGBB union BYGYB owing
Solution for opium: trace BBBBB soily BYGBB union YBGYB opium
Solution for dingo: trace BBBBB soily BYYBB dingo
Solution for hippo: trace BBBBB soily BYYBB dingo BGBBG hippo
Solution for bingo: trace BBBBB soily BYYBB dingo BGGGG bingo
Solution for inbox: trace BBBBB soily BYYBB dingo BYYBY inbox
Solution for widow: trace BBBBB soily BYYBB dingo YGBBY widow
Solution for ovoid: trace BBBBB soily BYYBB dingo YYBBY ovoid
Solution for lingo: trace BBBBB soily BYYYB lingo
Solution for limbo: trace BBBBB soily BYYYB lingo GGBBG limbo
Solution for igloo: trace BBBBB soily BYYYB lingo YYBYG igloo
Solution for spunk: trace BBBBB soily GBBBB spunk
Solution for shush: trace BBBBB soily GBBBB spunk GBGBB shush
Solution for swung: trace BBBBB soily GBBBB spunk GBGGB swung
Solution for skunk: trace BBBBB soily GBBBB spunk GBGGG skunk
Solution for snuff: trace BBBBB soily GBBBB spunk GBGYB snuff
Solution for sunny: trace BBBBB soily GBBBG sunny
Solution for skull: trace BBBBB soily GBBGB skull
Solution for skulk: trace BBBBB soily GBBGB skull GGGGB skulk
Solution for sully: trace BBBBB soily GBBGG sully
Solution for shyly: trace BBBBB soily GBBGG sully GBBGG shyly
Solution for slyly: trace BBBBB soily GBBGG sully GBYGG slyly
Solution for slump: trace BBBBB soily GBBYB whang BBBBB slump
Solution for slunk: trace BBBBB soily GBBYB whang BBBGB slunk
Solution for slung: trace BBBBB soily GBBYB whang BBBGG slung
Solution for slush: trace BBBBB soily GBBYB whang BYBBB slush
Solution for sulky: trace BBBBB soily GBBYG sulky
Solution for skiff: trace BBBBB soily GBGBB unmew BBBBB skiff
Solution for swish: trace BBBBB soily GBGBB unmew BBBBY swish
Solution for skimp: trace BBBBB soily GBGBB unmew BBYBB skimp
Solution for sniff: trace BBBBB soily GBGBB unmew BGBBB sniff
Solution for swing: trace BBBBB soily GBGBB unmew BYBBY swing
Solution for suing: trace BBBBB soily GBGBB unmew YYBBB suing
Solution for spiny: trace BBBBB soily GBGBG spiny
Solution for shiny: trace BBBBB soily GBGBG spiny GBGGG shiny
Solution for spiky: trace BBBBB soily GBGBG spiny GGGBG spiky
Solution for skill: trace BBBBB soily GBGGB yawps BBBBY skill
Solution for spill: trace BBBBB soily GBGGB yawps BBBYY spill
Solution for swill: trace BBBBB soily GBGGB yawps BBYBY swill
Solution for slink: trace BBBBB soily GBGYB slink
Solution for sling: trace BBBBB soily GBGYB slink GGGGB sling
Solution for slimy: trace BBBBB soily GBGYG slimy
Solution for sushi: trace BBBBB soily GBYBB sushi
Solution for squib: trace BBBBB soily GBYBB sushi GYBBY squib
Solution for sissy: trace BBBBB soily GBYBG sissy
Solution for silly: trace BBBBB soily GBYGG silly
Solution for silky: trace BBBBB soily GBYYG silky
Solution for sound: trace BBBBB soily GGBBB sound
Solution for soggy: trace BBBBB soily GGBBG soggy
Solution for solid: trace BBBBB soily GGYYB solid
Solution for spoon: trace BBBBB soily GYBBB spoon
Solution for shown: trace BBBBB soily GYBBB spoon GBGBG shown
Solution for shook: trace BBBBB soily GYBBB spoon GBGGB shook
Solution for swoon: trace BBBBB soily GYBBB spoon GBGGG swoon
Solution for spook: trace BBBBB soily GYBBB spoon GGGGB spook
Solution for spoof: trace BBBBB soily GYBBB spoon GGGGB spook GGGGB spoof
Solution for swoop: trace BBBBB soily GYBBB spoon GYGGB swoop
Solution for snoop: trace BBBBB soily GYBBB spoon GYGGY snoop
Solution for snowy: trace BBBBB soily GYBBG snowy
Solution for smoky: trace BBBBB soily GYBBG snowy GBGBG smoky
Solution for showy: trace BBBBB soily GYBBG snowy GBGGG showy
Solution for synod: trace BBBBB soily GYBBY synod
Solution for spool: trace BBBBB soily GYBYB spool
Solution for slosh: trace BBBBB soily GYBYB spool GBGBY slosh
Solution for sloop: trace BBBBB soily GYBYB spool GYGGY sloop
Solution for spoil: trace BBBBB soily GYYYB spoil
Solution for humus: trace BBBBB soily YBBBB humus
Solution for gypsy: trace BBBBB soily YBBBG hokum BBBBB gypsy
Solution for fussy: trace BBBBB soily YBBBG hokum BBBYB fussy
Solution for dusky: trace BBBBB soily YBBBG hokum BBYYB dusky
Solution for musky: trace BBBBB soily YBBBG hokum BBYYY musky
Solution for hussy: trace BBBBB soily YBBBG hokum GBBYB hussy
Solution for husky: trace BBBBB soily YBBBG hokum GBYYB husky
Solution for pushy: trace BBBBB soily YBBBG hokum YBBYB pushy
Solution for bushy: trace BBBBB soily YBBBG hokum YBBYB pushy BGGGG bushy
Solution for mushy: trace BBBBB soily YBBBG hokum YBBYY mushy
Solution for lupus: trace BBBBB soily YBBYB spifs BYBBG lupus
Solution for blush: trace BBBBB soily YBBYB spifs YBBBB blush
Solution for flush: trace BBBBB soily YBBYB spifs YBBYB flush
Solution for plush: trace BBBBB soily YBBYB spifs YYBBB plush
Solution for whisk: trace BBBBB soily YBGBB whisk
Solution for using: trace BBBBB soily YBGBB whisk BBGYB using
Solution for bliss: trace BBBBB soily YBGYB bliss
Solution for minus: trace BBBBB soily YBYBB minus
Solution for gipsy: trace BBBBB soily YBYBG gipsy
Solution for missy: trace BBBBB soily YBYBG gipsy BGBGG missy
Solution for fishy: trace BBBBB soily YBYBG gipsy BGBYG fishy
Solution for wispy: trace BBBBB soily YBYBG gipsy BGYYG wispy
Solution for bosom: trace BBBBB soily YGBBB bosom
Solution for bonus: trace BBBBB soily YGBBB bosom GGYBB bonus
Solution for mossy: trace BBBBB soily YGBBG mossy
Solution for bossy: trace BBBBB soily YGBBG mossy BGGGG bossy
Solution for lousy: trace BBBBB soily YGBYG lousy
Solution for noisy: trace BBBBB soily YGGBG noisy
Solution for gloss: trace BBBBB soily YYBYB gloss
Solution for floss: trace BBBBB soily YYBYB gloss BGGGG floss
Solution for kiosk: trace BBBBB soily YYYBB kiosk
Solution for bison: trace BBBBB soily YYYBB kiosk BGYYB bison
Solution for evoke: trace BBBBG sling BBBBB zuzim BBBBB evoke
Solution for femme: trace BBBBG sling BBBBB zuzim BBBBY femme
Solution for queue: trace BBBBG sling BBBBB zuzim BGBBB queue
Solution for booze: trace BBBBG sling BBBBB zuzim YBBBB booze
Solution for hedge: trace BBBBG sling BBBBY wojus BBBBB hedge
Solution for fugue: trace BBBBG sling BBBBY wojus BBBGB fugue
Solution for fudge: trace BBBBG sling BBBBY wojus BBBYB fudge
Solution for budge: trace BBBBG sling BBBBY wojus BBBYB fudge BGGGG budge
Solution for judge: trace BBBBG sling BBBBY wojus BBYYB judge
Solution for dodge: trace BBBBG sling BBBBY wojus BGBBB dodge
Solution for vogue: trace BBBBG sling BBBBY wojus BGBGB vogue
Solution for gouge: trace BBBBG sling BBBBY wojus BGBYB gouge
Solution for wedge: trace BBBBG sling BBBBY wojus GBBBB wedge
Solution for phone: trace BBBBG sling BBBGB phone
Solution for ozone: trace BBBBG sling BBBGB phone BBGGG ozone
Solution for penne: trace BBBBG sling BBBGB phone GBBGG penne
Solution for venue: trace BBBBG sling BBBYB venue
Solution for undue: trace BBBBG sling BBBYB venue BBYGG undue
Solution for nudge: trace BBBBG sling BBBYY nudge
Solution for gnome: trace BBBBG sling BBBYY nudge YBBYG gnome
Solution for oxide: trace BBBBG sling BBGBB oxide
Solution for guide: trace BBBBG sling BBGBY guide
Solution for ovine: trace BBBBG sling BBGGB ovine
Solution for whine: trace BBBBG sling BBGGB ovine BBGGG whine
Solution for opine: trace BBBBG sling BBGGB ovine GBGGG opine
Solution for knife: trace BBBBG sling BBGYB knife
Solution for movie: trace BBBBG sling BBYBB movie
Solution for pixie: trace BBBBG sling BBYBB movie BBBGG pixie
Solution for pique: trace BBBBG sling BBYBB movie BBBYG pique
Solution for diode: trace BBBBG sling BBYBB movie BYBYG diode
Solution for imbue: trace BBBBG sling BBYBB movie YBBYG imbue
Solution for biome: trace BBBBG sling BBYBB movie YYBYG biome
Solution for midge: trace BBBBG sling BBYBY midge
Solution for hinge: trace BBBBG sling BBYYY hinge
Solution for binge: trace BBBBG sling BBYYY hinge BGGGG binge
Solution for genie: trace BBBBG sling BBYYY hinge BYGYG genie
Solution for bloke: trace BBBBG sling BGBBB umped BBBYB bloke
Solution for elope: trace BBBBG sling BGBBB umped BBYYB elope
Solution for fluke: trace BBBBG sling BGBBB umped YBBYB fluke
Solution for elude: trace BBBBG sling BGBBB umped YBBYY elude
Solution for flume: trace BBBBG sling BGBBB umped YYBYB flume
Solution for plume: trace BBBBG sling BGBBB umped YYYYB plume
Solution for glove: trace BBBBG sling BGBBY glove
Solution for globe: trace BBBBG sling BGBBY glove GGGBG globe
Solution for olive: trace BBBBG sling BGGBB olive
Solution for elide: trace BBBBG sling BGGBB olive BGGBG elide
Solution for glide: trace BBBBG sling BGGBY glide
Solution for melee: trace BBBBG sling BYBBB zoned BBBGB melee
Solution for belle: trace BBBBG sling BYBBB zoned BBBYB belle
Solution for delve: trace BBBBG sling BYBBB zoned BBBYY delve
Solution for boule: trace BBBBG sling BYBBB zoned BGBYB boule
Solution for whole: trace BBBBG sling BYBBB zoned BYBYB whole
Solution for lodge: trace BBBBG sling BYBBY lodge
Solution for ledge: trace BBBBG sling BYBBY lodge GBGGG ledge
Solution for bulge: trace BBBBG sling BYBBY lodge YBBGG bulge
Solution for bugle: trace BBBBG sling BYBBY lodge YBBYG bugle
Solution for noble: trace BBBBG sling BYBYB noble
Solution for lunge: trace BBBBG sling BYBYY lunge
Solution for while: trace BBBBG sling BYGBB while
Solution for exile: trace BBBBG sling BYGBB while BBGGG exile
Solution for guile: trace BBBBG sling BYGBY guile
Solution for bible: trace BBBBG sling BYYBB bible
Solution for belie: trace BBBBG sling BYYBB bible GYBYG belie
Solution for liege: trace BBBBG sling BYYBY liege
Solution for bilge: trace BBBBG sling BYYBY liege YGBGG bilge
Solution for spoke: trace BBBBG sling GBBBB spoke
Solution for shove: trace BBBBG sling GBBBB spoke GBGBG shove
Solution for smoke: trace BBBBG sling GBBBB spoke GBGGG smoke
Solution for segue: trace BBBBG sling GBBBY segue
Solution for shone: trace BBBBG sling GBBGB shone
Solution for sense: trace BBBBG sling GBBYB sense
Solution for spike: trace BBBBG sling GBGBB spike
Solution for seize: trace BBBBG sling GBGBB spike GBGBG seize
Solution for shine: trace BBBBG sling GBGGB yawps BBBBY shine
Solution for spine: trace BBBBG sling GBGGB yawps BBBYY spine
Solution for swine: trace BBBBG sling GBGGB yawps BBYBY swine
Solution for snipe: trace BBBBG sling GBGYB snipe
Solution for snide: trace BBBBG sling GBGYB snipe GGGBG snide
Solution for sieve: trace BBBBG sling GBYBB sieve
Solution for siege: trace BBBBG sling GBYBY siege
Solution for singe: trace BBBBG sling GBYYY singe
Solution for slope: trace BBBBG sling GGBBB slope
Solution for slime: trace BBBBG sling GGGBB slime
Solution for slide: trace BBBBG sling GGGBB slime GGGBG slide
Solution for solve: trace BBBBG sling GYBBB solve
Solution for smile: trace BBBBG sling GYGBB smile
Solution for obese: trace BBBBG sling YBBBB whump BBBBB obese
Solution for posse: trace BBBBG sling YBBBB whump BBBBY posse
Solution for moose: trace BBBBG sling YBBBB whump BBBYB moose
Solution for mouse: trace BBBBG sling YBBBB whump BBGYB mouse
Solution for house: trace BBBBG sling YBBBB whump BYGBB house
Solution for whose: trace BBBBG sling YBBBB whump GGBBB whose
Solution for goose: trace BBBBG sling YBBBY goose
Solution for geese: trace BBBBG sling YBBBY goose GBBGG geese
Solution for noose: trace BBBBG sling YBBYB noose
Solution for dense: trace BBBBG sling YBBYB noose YBBGG dense
Solution for ensue: trace BBBBG sling YBBYB noose YBBYG ensue
Solution for poise: trace BBBBG sling YBGBB poise
Solution for guise: trace BBBBG sling YBGBY guise
Solution for noise: trace BBBBG sling YBGYB noise
Solution for issue: trace BBBBG sling YBYBB issue
Solution for pulse: trace BBBBG sling YYBBB pulse
Solution for loose: trace BBBBG sling YYBBB pulse BBYGG loose
Solution for louse: trace BBBBG sling YYBBB pulse BYYGG louse
Solution for sweep: trace BBBBY lined BBBGB sweep
Solution for gooey: trace BBBBY lined BBBGB sweep BBBGB gooey
Solution for sheep: trace BBBBY lined BBBGB sweep GBGGG sheep
Solution for speed: trace BBBBY lined BBBGG speed
Solution for embed: trace BBBBY lined BBBGG speed BBYGG embed
Solution for bused: trace BBBBY lined BBBGG speed YBBGG bused
Solution for modem: trace BBBBY lined BBBGY modem
Solution for dopey: trace BBBBY lined BBBGY modem BGYGB dopey
Solution for pesky: trace BBBBY lined BBBYB pesky
Solution for beefy: trace BBBBY lined BBBYB pesky BGBBG beefy
Solution for geeky: trace BBBBY lined BBBYB pesky BGBGG geeky
Solution for guess: trace BBBBY lined BBBYB pesky BYYBB guess
Solution for poesy: trace BBBBY lined BBBYB pesky GYYBG poesy
Solution for epoxy: trace BBBBY lined BBBYB pesky YYBBG epoxy
Solution for weedy: trace BBBBY lined BBBYY weedy
Solution for debug: trace BBBBY lined BBBYY weedy BGBYB debug
Solution for seedy: trace BBBBY lined BBBYY weedy BGGGG seedy
Solution for honey: trace BBBBY lined BBGGB zombi BGBBB honey
Solution for boney: trace BBBBY lined BBGGB zombi BGBYB boney
Solution for money: trace BBBBY lined BBGGB zombi BGYBB money
Solution for venom: trace BBBBY lined BBGYB venom
Solution for penny: trace BBBBY lined BBGYB venom BGGBB penny
Solution for queen: trace BBBBY lined BBYGB omovs BBBBB queen
Solution for sheen: trace BBBBY lined BBYGB omovs BBBBY sheen
Solution for seven: trace BBBBY lined BBYGB omovs BBBYY seven
Solution for hymen: trace BBBBY lined BBYGB omovs BYBBB hymen
Solution for semen: trace BBBBY lined BBYGB omovs BYBBY semen
Solution for woken: trace BBBBY lined BBYGB omovs YBBBB woken
Solution for nosey: trace BBBBY lined BBYGB omovs YBBBY nosey
Solution for woven: trace BBBBY lined BBYGB omovs YBBYB woven
Solution for women: trace BBBBY lined BBYGB omovs YYBBB women
Solution for unwed: trace BBBBY lined BBYGG unwed
Solution for kneed: trace BBBBY lined BBYGG unwed BGBGG kneed
Solution for unfed: trace BBBBY lined BBYGG unwed GGBGG unfed
Solution for dozen: trace BBBBY lined BBYGY dozen
Solution for envoy: trace BBBBY lined BBYYB envoy
Solution for enemy: trace BBBBY lined BBYYB envoy GGBBG enemy
Solution for enjoy: trace BBBBY lined BBYYB envoy GGBGG enjoy
Solution for ebony: trace BBBBY lined BBYYB envoy GYBYG ebony
Solution for begun: trace BBBBY lined BBYYB envoy YYBBB begun
Solution for spend: trace BBBBY lined BBYYG spend
Solution for needy: trace BBBBY lined BBYYY needy
Solution for demon: trace BBBBY lined BBYYY needy YGBYB demon
Solution for endow: trace BBBBY lined BBYYY needy YYBYB endow
Solution for video: trace BBBBY lined BGBGY video
Solution for sinew: trace BBBBY lined BGGGB sinew
Solution for piney: trace BBBBY lined BGGGB sinew BGGGB piney
Solution for vixen: trace BBBBY lined BGYGB vixen
Solution for given: trace BBBBY lined BGYGB vixen YGBGG given
Solution for widen: trace BBBBY lined BGYGY widen
Solution for fiend: trace BBBBY lined BGYYG fiend
Solution for spied: trace BBBBY lined BYBGG spied
Solution for shied: trace BBBBY lined BYBGG spied GBGGG shied
Solution for weigh: trace BBBBY lined BYBYB weigh
Solution for equip: trace BBBBY lined BYBYB weigh BYYBB equip
Solution for sheik: trace BBBBY lined BYBYB weigh BYYBY sheik
Solution for edify: trace BBBBY lined BYBYY edify
Solution for ennui: trace BBBBY lined BYGYB ennui
Solution for denim: trace BBBBY lined BYGYY denim
Solution for index: trace BBBBY lined BYYGY index
Solution for neigh: trace BBBBY lined BYYYB neigh
Solution for feign: trace BBBBY lined BYYYB neigh YGGGB feign
Solution for being: trace BBBBY lined BYYYB neigh YGGYB being
Solution for begin: trace BBBBY lined BYYYB neigh YGYYB begin
Solution for eying: trace BBBBY lined BYYYB neigh YYGYB eying
Solution for eking: trace BBBBY lined BYYYB neigh YYGYB eying GBGGG eking
Solution for deign: trace BBBBY lined BYYYY deign
Solution for level: trace BBBBY lined GBBGB level
Solution for leggy: trace BBBBY lined GBBYB leggy
Solution for lumen: trace BBBBY lined GBYGB lumen
Solution for lemon: trace BBBBY lined GBYYB lemon
Solution for libel: trace BBBBY lined GGBGB libel
Solution for linen: trace BBBBY lined GGGGB linen
Solution for liken: trace BBBBY lined GGYGB liken
Solution for bowel: trace BBBBY lined YBBGB bowel
Solution for expel: trace BBBBY lined YBBGB bowel BBBGG expel
Solution for sleep: trace BBBBY lined YBBGB bowel BBBGY sleep
Solution for sleek: trace BBBBY lined YBBGB bowel BBBGY sleep GGGGB sleek
Solution for jewel: trace BBBBY lined YBBGB bowel BBGGG jewel
Solution for wheel: trace BBBBY lined YBBGB bowel BBYGG wheel
Solution for hovel: trace BBBBY lined YBBGB bowel BGBGG hovel
Solution for golem: trace BBBBY lined YBBGB bowel BGBGY golem
Solution for vowel: trace BBBBY lined YBBGB bowel BGGGG vowel
Solution for bezel: trace BBBBY lined YBBGB bowel GBBGG bezel
Solution for bevel: trace BBBBY lined YBBGB bowel GBBGG bezel GGBGG bevel
Solution for bleep: trace BBBBY lined YBBGB bowel GBBGY bleep
Solution for bleed: trace BBBBY lined YBBGG bleed
Solution for model: trace BBBBY lined YBBGY model
Solution for dowel: trace BBBBY lined YBBGY model BGYGG dowel
Solution for shelf: trace BBBBY lined YBBYB polls BBBGY shelf
Solution for welsh: trace BBBBY lined YBBYB polls BBGBY welsh
Solution for jelly: trace BBBBY lined YBBYB polls BBGGB jelly
Solution for belly: trace BBBBY lined YBBYB polls BBGGB jelly BGGGG belly
Solution for elegy: trace BBBBY lined YBBYB polls BBYBB elegy
Solution for bless: trace BBBBY lined YBBYB polls BBYBG bless
Solution for flesh: trace BBBBY lined YBBYB polls BBYBY flesh
Solution for quell: trace BBBBY lined YBBYB polls BBYGB quell
Solution for swell: trace BBBBY lined YBBYB polls BBYGY zhomo BBBBB swell
Solution for smell: trace BBBBY lined YBBYB polls BBYGY zhomo BBBYB smell
Solution for shell: trace BBBBY lined YBBYB polls BBYGY zhomo BGBBB shell
Solution for below: trace BBBBY lined YBBYB polls BYGBB below
Solution for hello: trace BBBBY lined YBBYB polls BYGGB hello
Solution for elbow: trace BBBBY lined YBBYB polls BYYBB elbow
Solution for whelp: trace BBBBY lined YBBYB polls YBBGB whelp
Solution for spell: trace BBBBY lined YBBYB polls YBYGY spell
Solution for dwell: trace BBBBY lined YBBYY dwell
Solution for novel: trace BBBBY lined YBYGB novel
Solution for kneel: trace BBBBY lined YBYGB novel YBBGG kneel
Solution for olden: trace BBBBY lined YBYGY olden
Solution for melon: trace BBBBY lined YBYYB melon
Solution for felon: trace BBBBY lined YBYYB melon BGGGG felon
Solution for newly: trace BBBBY lined YBYYB melon BGYBY newly
Solution for blend: trace BBBBY lined YBYYG blend
Solution for pixel: trace BBBBY lined YGBGB pixel
Solution for wield: trace BBBBY lined YGBYG yufts BBBBB wield
Solution for field: trace BBBBY lined YGBYG yufts BBYBB field
Solution for yield: trace BBBBY lined YGBYG yufts GBBBB yield
Solution for spiel: trace BBBBY lined YYBGB spiel
Solution for impel: trace BBBBY lined YYBGB spiel BYYGG impel
Solution for plied: trace BBBBY lined YYBGG plied
Solution for helix: trace BBBBY lined YYBYB helix
Solution for devil: trace BBBBY lined YYBYY devil
Solution for elfin: trace BBBBY lined YYYYB elfin
Solution for clock: trace BBBGB cuish GBBBB clock
Solution for conch: trace BBBGB cuish GBBBG conch
Solution for chock: trace BBBGB cuish GBBBY chock
Solution for click: trace BBBGB cuish GBGBB click
Solution for chick: trace BBBGB cuish GBGBY chick
Solution for cinch: trace BBBGB cuish GBYBG cinch
Solution for cluck: trace BBBGB cuish GYBBB cluck
Solution for couch: trace BBBGB cuish GYBBG couch
Solution for chuck: trace BBBGB cuish GYBBY chuck
Solution for flock: trace BBBGB cuish YBBBB flock
Solution for knock: trace BBBGB cuish YBBBB flock BBGGG knock
Solution for block: trace BBBGB cuish YBBBB flock BGGGG block
Solution for pooch: trace BBBGB cuish YBBBG pooch
Solution for smock: trace BBBGB cuish YBBYB smock
Solution for shock: trace BBBGB cuish YBBYY shock
Solution for flick: trace BBBGB cuish YBGBB flick
Solution for which: trace BBBGB cuish YBGBG which
Solution for spicy: trace BBBGB cuish YBGYB spicy
Solution for slick: trace BBBGB cuish YBGYB spicy GBGGB slick
Solution for finch: trace BBBGB cuish YBYBG yawps BBBBB finch
Solution for pinch: trace BBBGB cuish YBYBG yawps BBBYB pinch
Solution for winch: trace BBBGB cuish YBYBG yawps BBYBB winch
Solution for disco: trace BBBGB cuish YBYYB disco
Solution for hunch: trace BBBGB cuish YGBBG pulmo BGBBB hunch
Solution for bunch: trace BBBGB cuish YGBBG pulmo BGBBB hunch BGGGG bunch
Solution for munch: trace BBBGB cuish YGBBG pulmo BGBYB munch
Solution for gulch: trace BBBGB cuish YGBBG pulmo BGGBB gulch
Solution for mulch: trace BBBGB cuish YGBBG pulmo BGGYB mulch
Solution for lunch: trace BBBGB cuish YGBBG pulmo BGYBB lunch
Solution for punch: trace BBBGB cuish YGBBG pulmo GGBBB punch
Solution for quick: trace BBBGB cuish YGGBB quick
Solution for juicy: trace BBBGB cuish YGGBB quick BGGGB juicy
Solution for pluck: trace BBBGB cuish YYBBB pluck
Solution for vouch: trace BBBGB cuish YYBBG vouch
Solution for pouch: trace BBBGB cuish YYBBG vouch BGGGG pouch
Solution for snuck: trace BBBGB cuish YYBYB snuck
Solution for shuck: trace BBBGB cuish YYBYY shuck
Solution for juice: trace BBBGG ponds BBBBB juice
Solution for slice: trace BBBGG ponds BBBBY slice
Solution for deuce: trace BBBGG ponds BBBYB deuce
Solution for fence: trace BBBGG ponds BBGBB withy BBBBB fence
Solution for hence: trace BBBGG ponds BBGBB withy BBBYB hence
Solution for mince: trace BBBGG ponds BBGBB withy BGBBB mince
Solution for wince: trace BBBGG ponds BBGBB withy GGBBB wince
Solution for since: trace BBBGG ponds BBGBY since
Solution for dunce: trace BBBGG ponds BBGYB dunce
Solution for niece: trace BBBGG ponds BBYBB niece
Solution for voice: trace BBBGG ponds BGBBB voice
Solution for ounce: trace BBBGG ponds BYGBB ounce
Solution for piece: trace BBBGG ponds GBBBB piece
Solution for pence: trace BBBGG ponds GBGBB pence
Solution for spice: trace BBBGG ponds YBBBY spice
Solution for speck: trace BBBGY whelp BBGBY speck
Solution for fleck: trace BBBGY whelp BBGYB fleck
Solution for check: trace BBBGY whelp BGGBB check
Solution for beech: trace BBBGY whelp BYGBB beech
Solution for leech: trace BBBGY whelp BYGYB leech
Solution for bench: trace BBBGY whelp BYYBB bench
Solution for epoch: trace BBBGY whelp BYYBY epoch
Solution for belch: trace BBBGY whelp BYYYB belch
Solution for welch: trace BBBGY whelp GYYYB welch
Solution for condo: trace BBBYB muils BBBBB condo
Solution for scoop: trace BBBYB muils BBBBY scoop
Solution for scoff: trace BBBYB muils BBBBY scoop GGGBB scoff
Solution for coyly: trace BBBYB muils BBBGB coyly
Solution for scold: trace BBBYB muils BBBGY scold
Solution for colon: trace BBBYB muils BBBYB colon
Solution for clown: trace BBBYB muils BBBYB colon GYYBG clown
Solution for scowl: trace BBBYB muils BBBYY scowl
Solution for icing: trace BBBYB muils BBGBB icing
Solution for scion: trace BBBYB muils BBGBY scion
Solution for chill: trace BBBYB muils BBGGB yodel BBBBG chill
Solution for chili: trace BBBYB muils BBGGB yodel BBBBY chili
Solution for child: trace BBBYB muils BBGGB yodel BBYBY child
Solution for icily: trace BBBYB muils BBGGB yodel YBBBY icily
Solution for clink: trace BBBYB muils BBGYB clink
Solution for cliff: trace BBBYB muils BBGYB clink GGGBB cliff
Solution for cling: trace BBBYB muils BBGYB clink GGGGB cling
Solution for ionic: trace BBBYB muils BBYBB ionic
Solution for cynic: trace BBBYB muils BBYBB ionic BBGGG cynic
Solution for conic: trace BBBYB muils BBYBB ionic BGGGG conic
Solution for picky: trace BBBYB muils BBYBB ionic YBBBY picky
Solution for civic: trace BBBYB muils BBYBB ionic YBBGG civic
Solution for sonic: trace BBBYB muils BBYBY sonic
Solution for logic: trace BBBYB muils BBYYB logic
Solution for civil: trace BBBYB muils BBYYB logic YBBGY civil
Solution for duchy: trace BBBYB muils BGBBB duchy
Solution for lucky: trace BBBYB muils BGBYB lucky
Solution for pubic: trace BBBYB muils BGYBB pubic
Solution for cubic: trace BBBYB muils BGYBB pubic BGGGG cubic
Solution for lucid: trace BBBYB muils BGYYB lucid
Solution for cough: trace BBBYB muils BYBBB cough
Solution for chunk: trace BBBYB muils BYBBB cough GBGBY chunk
Solution for focus: trace BBBYB muils BYBBG focus
Solution for could: trace BBBYB muils BYBGB could
Solution for clung: trace BBBYB muils BYBYB clung
Solution for cloud: trace BBBYB muils BYBYB clung GGYBB cloud
Solution for locus: trace BBBYB muils BYBYG locus
Solution for ficus: trace BBBYB muils BYYBG ficus
Solution for mimic: trace BBBYB muils GBYBB mimic
Solution for mucky: trace BBBYB muils GGBBB mucky
Solution for mucus: trace BBBYB muils GGBBG mucus
Solution for music: trace BBBYB muils GGYBY music
Solution for comfy: trace BBBYB muils YBBBB comfy
Solution for climb: trace BBBYB muils YBGYB climb
Solution for comic: trace BBBYB muils YBYBB comic
Solution for cumin: trace BBBYB muils YGYBB cumin
Solution for chump: trace BBBYB muils YYBBB chump
Solution for clump: trace BBBYB muils YYBYB clump
Solution for chime: trace BBBYG clons GBBBB chime
Solution for chide: trace BBBYG clons GBBBB chime GGGBG chide
Solution for choke: trace BBBYG clons GBGBB choke
Solution for chose: trace BBBYG clons GBGBY chose
Solution for coupe: trace BBBYG clons GBYBB coupe
Solution for copse: trace BBBYG clons GBYBY copse
Solution for clove: trace BBBYG clons GGGBB clove
Solution for close: trace BBBYG clons GGGBY close
Solution for clone: trace BBBYG clons GGGGB clone
Solution for cycle: trace BBBYG clons GYBBB cycle
Solution for emcee: trace BBBYG clons YBBBB emcee
Solution for scene: trace BBBYG clons YBBGY scene
Solution for niche: trace BBBYG clons YBBYB niche
Solution for scope: trace BBBYG clons YBGBY scope
Solution for scone: trace BBBYG clons YBGGY scone
Solution for uncle: trace BBBYG clons YYBYB uncle
Solution for cheek: trace BBBYY oiled BBBGB cheek
Solution for chess: trace BBBYY oiled BBBYB chess
Solution for excel: trace BBBYY oiled BBYGB excel
Solution for clued: trace BBBYY oiled BBYGG clued
Solution for bicep: trace BBBYY oiled BGBGB bicep
Solution for dicey: trace BBBYY oiled BGBGY dicey
Solution for chief: trace BBBYY oiled BYBGB chief
Solution for medic: trace BBBYY oiled BYBYY medic
Solution for covey: trace BBBYY oiled YBBGB covey
Solution for coven: trace BBBYY oiled YBBGB covey GGGGB coven
Solution for gecko: trace BBBYY oiled YBBYB gecko
Solution for decoy: trace BBBYY oiled YBBYY decoy
Solution for cello: trace BBBYY oiled YBGYB cello
Solution for foamy: trace BBGBB shuln BBBBB foamy
Solution for again: trace BBGBB shuln BBBBG again
Solution for piano: trace BBGBB shuln BBBBY piano
Solution for koala: trace BBGBB shuln BBBGB koala
Solution for flail: trace BBGBB shuln BBBYB flail
Solution for avail: trace BBGBB shuln BBBYB flail BBGGG avail
Solution for plaza: trace BBGBB shuln BBBYB flail BGGBB plaza
Solution for llama: trace BBGBB shuln BBBYB flail BGGBY llama
Solution for plaid: trace BBGBB shuln BBBYB flail BGGGB plaid
Solution for loamy: trace BBGBB shuln BBBYB flail BYGBB loamy
Solution for flaky: trace BBGBB shuln BBBYB flail GGGBB flaky
Solution for plain: trace BBGBB shuln BBBYG plain
Solution for flank: trace BBGBB shuln BBBYY bipod BBBBB flank
Solution for gland: trace BBGBB shuln BBBYY bipod BBBBG gland
Solution for plank: trace BBGBB shuln BBBYY bipod BBYBB plank
Solution for blank: trace BBGBB shuln BBBYY bipod GBBBB blank
Solution for bland: trace BBGBB shuln BBBYY bipod GBBBG bland
Solution for guava: trace BBGBB shuln BBYBB guava
Solution for qualm: trace BBGBB shuln BBYGB qualm
Solution for quail: trace BBGBB shuln BBYYB quail
Solution for khaki: trace BBGBB shuln BGBBB khaki
Solution for swamp: trace BBGBB shuln GBBBB swamp
Solution for soapy: trace BBGBB shuln GBBBB swamp GBGBY soapy
Solution for spasm: trace BBGBB shuln GBBBB swamp GBGYY spasm
Solution for swami: trace BBGBB shuln GBBBB swamp GGGGB swami
Solution for spawn: trace BBGBB shuln GBBBG spawn
Solution for spank: trace BBGBB shuln GBBBY spank
Solution for snaky: trace BBGBB shuln GBBBY spank GBGYY snaky
Solution for small: trace BBGBB shuln GBBGB small
Solution for slain: trace BBGBB shuln GBBYG slain
Solution for snail: trace BBGBB shuln GBBYY snail
Solution for slang: trace BBGBB shuln GBBYY snail GYGBY slang
Solution for shaky: trace BBGBB shuln GGBBB shaky
Solution for shady: trace BBGBB shuln GGBBB shaky GGGBG shady
Solution for shank: trace BBGBB shuln GGBBY shank
Solution for shall: trace BBGBB shuln GGBGB shall
Solution for shawl: trace BBGBB shuln GGBYB shawl
Solution for swash: trace BBGBB shuln GYBBB swash
Solution for smash: trace BBGBB shuln GYBBB swash GBGGG smash
Solution for slash: trace BBGBB shuln GYBYB slash
Solution for amass: trace BBGBB shuln YBBBB amass
Solution for psalm: trace BBGBB shuln YBBGB psalm
Solution for glass: trace BBGBB shuln YBBYB glass
Solution for flask: trace BBGBB shuln YBBYB glass BGGGB flask
Solution for quasi: trace BBGBB shuln YBYBB quasi
Solution for awash: trace BBGBB shuln YYBBB awash
Solution for gnash: trace BBGBB shuln YYBBY gnash
Solution for flash: trace BBGBB shuln YYBYB flash
Solution for quash: trace BBGBB shuln YYYBB quash
Solution for amaze: trace BBGBG sulph BBBBB windy BBBBB amaze
Solution for evade: trace BBGBG sulph BBBBB windy BBBGB evade
Solution for adage: trace BBGBG sulph BBBBB windy BBBYB adage
Solution for knave: trace BBGBG sulph BBBBB windy BBYBB knave
Solution for image: trace BBGBG sulph BBBBB windy BYBBB image
Solution for inane: trace BBGBG sulph BBBBB windy BYYBB inane
Solution for weave: trace BBGBG sulph BBBBB windy GBBBB weave
Solution for awake: trace BBGBG sulph BBBBB windy YBBBB awake
Solution for heave: trace BBGBG sulph BBBBY heave
Solution for agape: trace BBGBG sulph BBBGB agape
Solution for glaze: trace BBGBG sulph BBYBB embed YBBBB glaze
Solution for flake: trace BBGBG sulph BBYBB embed YBBBB glaze BGGBG flake
Solution for glade: trace BBGBG sulph BBYBB embed YBBBY glade
Solution for leave: trace BBGBG sulph BBYBB embed YBBYB leave
Solution for blaze: trace BBGBG sulph BBYBB embed YBYBB blaze
Solution for blade: trace BBGBG sulph BBYBB embed YBYBY blade
Solution for flame: trace BBGBG sulph BBYBB embed YYBBB flame
Solution for blame: trace BBGBG sulph BBYBB embed YYYBB blame
Solution for whale: trace BBGBG sulph BBYBY whale
Solution for plane: trace BBGBG sulph BBYYB plane
Solution for quake: trace BBGBG sulph BGBBB quake
Solution for snake: trace BBGBG sulph GBBBB snake
Solution for shame: trace BBGBG sulph GBBBY vodka BBBBY shame
Solution for shake: trace BBGBG sulph GBBBY vodka BBBGY shake
Solution for shade: trace BBGBG sulph GBBBY vodka BBYBY shade
Solution for shave: trace BBGBG sulph GBBBY vodka YBBBY shave
Solution for shape: trace BBGBG sulph GBBGY shape
Solution for spade: trace BBGBG sulph GBBYB spade
Solution for shale: trace BBGBG sulph GBYBY shale
Solution for suave: trace BBGBG sulph GGBBB suave
Solution for abase: trace BBGBG sulph YBBBB abase
Solution for phase: trace BBGBG sulph YBBYY phase
Solution for lease: trace BBGBG sulph YBYBB lease
Solution for usage: trace BBGBG sulph YYBBB usage
Solution for beady: trace BBGBY whilk BBBBB beady
Solution for mealy: trace BBGBY whilk BBBGB mealy
Solution for leafy: trace BBGBY whilk BBBYB leafy
Solution for leaky: trace BBGBY whilk BBBYY leaky
Solution for email: trace BBGBY whilk BBYYB email
Solution for heavy: trace BBGBY whilk BYBBB heavy
Solution for heady: trace BBGBY whilk BYBBB heavy GGGBG heady
Solution for leash: trace BBGBY whilk BYBYB leash
Solution for aback: trace BBGGB shuln BBBBB aback
Solution for knack: trace BBGGB shuln BBBBY knack
Solution for clack: trace BBGGB shuln BBBYB fubsy BBBBB clack
Solution for black: trace BBGGB shuln BBBYB fubsy BBYBB black
Solution for flack: trace BBGGB shuln BBBYB fubsy GBBBB flack
Solution for quack: trace BBGGB shuln BBYBB quack
Solution for whack: trace BBGGB shuln BGBBB whack
Solution for coach: trace BBGGB shuln BYBBB coach
Solution for smack: trace BBGGB shuln GBBBB smack
Solution for snack: trace BBGGB shuln GBBBY snack
Solution for slack: trace BBGGB shuln GBBYB slack
Solution for shack: trace BBGGB shuln GGBBB shack
Solution for place: trace BBGGG place
Solution for peace: trace BBGGG place GBGGG peace
Solution for space: trace BBGGG place YBGGG space
Solution for beach: trace BBGGY yelps BGBBB beach
Solution for peach: trace BBGGY yelps BGBYB peach
Solution for leach: trace BBGGY yelps BGYBB leach
Solution for chaff: trace BBGYB slips BBBBB chaff
Solution for chaos: trace BBGYB slips BBBBG chaos
Solution for champ: trace BBGYB slips BBBYB champ
Solution for chain: trace BBGYB slips BBYBB chain
Solution for clank: trace BBGYB slips BGBBB clank
Solution for clang: trace BBGYB slips BGBBB clank GGGGB clang
Solution for clamp: trace BBGYB slips BGBYB clamp
Solution for claim: trace BBGYB slips BGYBB claim
Solution for chalk: trace BBGYB slips BYBBB chalk
Solution for scamp: trace BBGYB slips GBBYB scamp
Solution for scaly: trace BBGYB slips GYBBB scaly
Solution for scald: trace BBGYB slips GYBBB scaly GGGGB scald
Solution for scalp: trace BBGYB slips GYBYB scalp
Solution for chasm: trace BBGYB slips YBBBB chasm
Solution for clash: trace BBGYB slips YGBBB clash
Solution for class: trace BBGYB slips YGBBG class
Solution for clasp: trace BBGYB slips YGBYB clasp
Solution for chase: trace BBGYG chase
Solution for cease: trace BBGYG chase GBGGG cease
Solution for chafe: trace BBGYG chase GGGBG chafe
Solution for scale: trace BBGYG chase YBGYG scale
Solution for maxim: trace BBYBB sonly BBBBB maxim
Solution for kappa: trace BBYBB sonly BBBBB maxim BGBBB kappa
Solution for vapid: trace BBYBB sonly BBBBB maxim BGBGB vapid
Solution for aphid: trace BBYBB sonly BBBBB maxim BYBGB aphid
Solution for pizza: trace BBYBB sonly BBBBB maxim BYBYB pizza
Solution for affix: trace BBYBB sonly BBBBB maxim BYYGB affix
Solution for madam: trace BBYBB sonly BBBBB maxim GGBBG madam
Solution for mamma: trace BBYBB sonly BBBBB maxim GGBBY mamma
Solution for magma: trace BBYBB sonly BBBBB maxim GGBBY mamma GGBGG magma
Solution for mafia: trace BBYBB sonly BBBBB maxim GGBGB mafia
Solution for gamma: trace BBYBB sonly BBBBB maxim YGBBY gamma
Solution for mammy: trace BBYBB sonly BBBBG pudgy BBBBG mammy
Solution for jazzy: trace BBYBB sonly BBBBG pudgy BBBBG mammy BGBBG jazzy
Solution for baggy: trace BBYBB sonly BBBBG pudgy BBBGG baggy
Solution for gawky: trace BBYBB sonly BBBBG pudgy BBBYG gawky
Solution for daddy: trace BBYBB sonly BBBBG pudgy BBGBG daddy
Solution for bawdy: trace BBYBB sonly BBBBG pudgy BBYBG bawdy
Solution for gaudy: trace BBYBB sonly BBBBG pudgy BYYYG gaudy
Solution for paddy: trace BBYBB sonly BBBBG pudgy GBGBG paddy
Solution for happy: trace BBYBB sonly BBBBG pudgy YBBBG happy
Solution for kayak: trace BBYBB sonly BBBBY kayak
Solution for villa: trace BBYBB sonly BBBGB villa
Solution for apply: trace BBYBB sonly BBBGG midgy BBBBG apply
Solution for gayly: trace BBYBB sonly BBBGG midgy BBBYG gayly
Solution for badly: trace BBYBB sonly BBBGG midgy BBGBG badly
Solution for dally: trace BBYBB sonly BBBGG midgy BBYBG dally
Solution for gaily: trace BBYBB sonly BBBGG midgy BYBYG gaily
Solution for daily: trace BBYBB sonly BBBGG midgy BYYBG daily
Solution for madly: trace BBYBB sonly BBBGG midgy GBGBG madly
Solution for amply: trace BBYBB sonly BBBGG midgy YBBBG amply
Solution for axial: trace BBYBB sonly BBBYB axial
Solution for awful: trace BBYBB sonly BBBYB axial GBBBG awful
Solution for album: trace BBYBB sonly BBBYB axial GBBBY album
Solution for alpha: trace BBYBB sonly BBBYB axial GBBYY alpha
Solution for alibi: trace BBYBB sonly BBBYB axial GBGBY alibi
Solution for laugh: trace BBYBB sonly BBBYB axial YBBBY laugh
Solution for papal: trace BBYBB sonly BBBYB axial YBBGG papal
Solution for valid: trace BBYBB sonly BBBYB axial YBYBY valid
Solution for balmy: trace BBYBB sonly BBBYG balmy
Solution for allay: trace BBYBB sonly BBBYG balmy BYGBG allay
Solution for bylaw: trace BBYBB sonly BBBYY bylaw
Solution for ninja: trace BBYBB sonly BBGBB ninja
Solution for manga: trace BBYBB sonly BBGBB ninja BBGBG manga
Solution for mania: trace BBYBB sonly BBGBB ninja BYGBG mania
Solution for nanny: trace BBYBB sonly BBGBG defog BBBBB nanny
Solution for mangy: trace BBYBB sonly BBGBG defog BBBBY mangy
Solution for fanny: trace BBYBB sonly BBGBG defog BBYBB fanny
Solution for dandy: trace BBYBB sonly BBGBG defog GBBBB dandy
Solution for handy: trace BBYBB sonly BBGBG defog YBBBB handy
Solution for manly: trace BBYBB sonly BBGGG manly
Solution for final: trace BBYBB sonly BBGYB final
Solution for banal: trace BBYBB sonly BBGYB final BBGGG banal
Solution for annul: trace BBYBB sonly BBGYB final BBGYG annul
Solution for lanky: trace BBYBB sonly BBGYG lanky
Solution for pagan: trace BBYBB sonly BBYBB pagan
Solution for human: trace BBYBB sonly BBYBB pagan BBBGG human
Solution for fauna: trace BBYBB sonly BBYBB pagan BGBYY fauna
Solution for admin: trace BBYBB sonly BBYBB pagan BYBBG admin
Solution for avian: trace BBYBB sonly BBYBB pagan BYBGG avian
Solution for aging: trace BBYBB sonly BBYBB pagan BYYBY aging
Solution for aping: trace BBYBB sonly BBYBB pagan YYYBY aping
Solution for naval: trace BBYBB sonly BBYYB naval
Solution for align: trace BBYBB sonly BBYYB naval YYBBY align
Solution for anvil: trace BBYBB sonly BBYYB naval YYGBG anvil
Solution for inlay: trace BBYBB sonly BBYYG inlay
Solution for vodka: trace BBYBB sonly BGBBB vodka
Solution for dogma: trace BBYBB sonly BGBBB vodka BGYBG dogma
Solution for voila: trace BBYBB sonly BGBGB voila
Solution for polka: trace BBYBB sonly BGBYB polka
Solution for modal: trace BBYBB sonly BGBYB polka BGYBY modal
Solution for loyal: trace BBYBB sonly BGBYY loyal
Solution for gonad: trace BBYBB sonly BGGBB gonad
Solution for zonal: trace BBYBB sonly BGGYB zonal
Solution for woman: trace BBYBB sonly BGYBB woman
Solution for nomad: trace BBYBB sonly BGYBB woman BGGGY nomad
Solution for mambo: trace BBYBB sonly BYBBB mambo
Solution for audio: trace BBYBB sonly BYBBB mambo BYBBG audio
Solution for avoid: trace BBYBB sonly BYBBB mambo BYBBY avoid
Solution for axiom: trace BBYBB sonly BYBBB mambo YYBBY axiom
Solution for bayou: trace BBYBB sonly BYBBY bayou
Solution for viola: trace BBYBB sonly BYBGB viola
Solution for aloud: trace BBYBB sonly BYBYB aloud
Solution for aloof: trace BBYBB sonly BYBYB aloud GGGBB aloof
Solution for allow: trace BBYBB sonly BYBYB aloud GGYBB allow
Solution for afoul: trace BBYBB sonly BYBYB aloud GYGGB afoul
Solution for aglow: trace BBYBB sonly BYBYB aloud GYYBB aglow
Solution for offal: trace BBYBB sonly BYBYB aloud YYYBB offal
Solution for alloy: trace BBYBB sonly BYBYG alloy
Solution for mango: trace BBYBB sonly BYGBB mango
Solution for banjo: trace BBYBB sonly BYGBB mango BGGBG banjo
Solution for annoy: trace BBYBB sonly BYGBG annoy
Solution for wagon: trace BBYBB sonly BYYBB wagon
Solution for axion: trace BBYBB sonly BYYBB wagon BYBGG axion
Solution for among: trace BBYBB sonly BYYBB wagon BYYYY among
Solution for agony: trace BBYBB sonly BYYBG agony
Solution for along: trace BBYBB sonly BYYYB along
Solution for squad: trace BBYBB sonly GBBBB squad
Solution for sigma: trace BBYBB sonly GBBBB squad GBBYB sigma
Solution for sassy: trace BBYBB sonly GBBBG wispy BBGBG sassy
Solution for savvy: trace BBYBB sonly GBBBG wispy BBYBG savvy
Solution for sappy: trace BBYBB sonly GBBBG wispy BBYGG sappy
Solution for sally: trace BBYBB sonly GBBGG sally
Solution for sadly: trace BBYBB sonly GBBGG sally GGBGG sadly
Solution for salsa: trace BBYBB sonly GBBYB salsa
Solution for salad: trace BBYBB sonly GBBYB salsa GGGBY salad
Solution for sandy: trace BBYBB sonly GBGBG sandy
Solution for sauna: trace BBYBB sonly GBYBB sauna
Solution for savoy: trace BBYBB sonly GYBBG savoy
Solution for shoal: trace BBYBB sonly GYBYB shoal
Solution for salvo: trace BBYBB sonly GYBYB shoal GBYYY salvo
Solution for salon: trace BBYBB sonly GYYYB salon
Solution for basis: trace BBYBB sonly YBBBB basis
Solution for amiss: trace BBYBB sonly YBBBB basis BYYYG amiss
Solution for gassy: trace BBYBB sonly YBBBG gassy
Solution for daisy: trace BBYBB sonly YBBBG gassy BGBGG daisy
Solution for assay: trace BBYBB sonly YBBBG gassy BYGYG assay
Solution for abyss: trace BBYBB sonly YBBBY abyss
Solution for usual: trace BBYBB sonly YBBYB usual
Solution for basal: trace BBYBB sonly YBBYB usual BYBGG basal
Solution for basil: trace BBYBB sonly YBBYB usual BYBYG basil
Solution for palsy: trace BBYBB sonly YBBYG palsy
Solution for pansy: trace BBYBB sonly YBGBG pansy
Solution for basin: trace BBYBB sonly YBYBB basin
Solution for nasal: trace BBYBB sonly YBYYB nasal
Solution for lasso: trace BBYBB sonly YYBYB lasso
Solution for mason: trace BBYBB sonly YYYBB mason
Solution for waive: trace BBYBG lambs BGBBB gungy BBBBB waive
Solution for payee: trace BBYBG lambs BGBBB gungy BBBBY payee
Solution for naive: trace BBYBG lambs BGBBB gungy BBYBB naive
Solution for gaffe: trace BBYBG lambs BGBBB gungy GBBBB gaffe
Solution for gauze: trace BBYBG lambs BGBBB gungy GYBBB gauze
Solution for gauge: trace BBYBG lambs BGBBB gungy GYBGB gauge
Solution for vague: trace BBYBG lambs BGBBB gungy YYBBB vague
Solution for pause: trace BBYBG lambs BGBBY pause
Solution for badge: trace BBYBG lambs BGBYB badge
Solution for mauve: trace BBYBG lambs BGYBB zygon BBBBB mauve
Solution for mange: trace BBYBG lambs BGYBB zygon BBYBY mange
Solution for maize: trace BBYBG lambs BGYBB zygon YBBBB maize
Solution for masse: trace BBYBG lambs BGYBY masse
Solution for maybe: trace BBYBG lambs BGYGB maybe
Solution for awoke: trace BBYBG lambs BYBBB awoke
Solution for anode: trace BBYBG lambs BYBBB awoke GBGBG anode
Solution for aside: trace BBYBG lambs BYBBY aside
Solution for adobe: trace BBYBG lambs BYBGB adobe
Solution for above: trace BBYBG lambs BYBYB above
Solution for abide: trace BBYBG lambs BYBYB above GGBBG abide
Solution for abode: trace BBYBG lambs BYBYB above GGGBG abode
Solution for abuse: trace BBYBG lambs BYBYY abuse
Solution for anime: trace BBYBG lambs BYYBB anime
Solution for amuse: trace BBYBG lambs BYYBY amuse
Solution for ladle: trace BBYBG lambs GGBBB ladle
Solution for lapse: trace BBYBG lambs GGBBY lapse
Solution for valve: trace BBYBG lambs YGBBB valve
Solution for halve: trace BBYBG lambs YGBBB valve BGGGG halve
Solution for eagle: trace BBYBG lambs YGBBB valve BGYBG eagle
Solution for value: trace BBYBG lambs YGBBB valve GGGBG value
Solution for salve: trace BBYBG lambs YGBBY salve
Solution for false: trace BBYBG lambs YGBBY salve YGGBG false
Solution for fable: trace BBYBG lambs YGBYB fable
Solution for maple: trace BBYBG lambs YGYBB maple
Solution for apple: trace BBYBG lambs YYBBB vying BBBBB apple
Solution for algae: trace BBYBG lambs YYBBB vying BBBBY algae
Solution for alone: trace BBYBG lambs YYBBB vying BBBGB alone
Solution for ankle: trace BBYBG lambs YYBBB vying BBBYB ankle
Solution for angle: trace BBYBG lambs YYBBB vying BBBYY angle
Solution for alike: trace BBYBG lambs YYBBB vying BBGBB alike
Solution for agile: trace BBYBG lambs YYBBB vying BBGBY agile
Solution for alive: trace BBYBG lambs YYBBB vying YBGBB alive
Solution for aisle: trace BBYBG lambs YYBBY aisle
Solution for ample: trace BBYBG lambs YYYBB ample
Solution for amble: trace BBYBG lambs YYYYB amble
Solution for abbey: trace BBYBY kneel BBBGB abbey
Solution for label: trace BBYBY kneel BBBGG pight BBBBB label
Solution for hazel: trace BBYBY kneel BBBGG pight BBBYB hazel
Solution for bagel: trace BBYBY kneel BBBGG pight BBGBB bagel
Solution for gavel: trace BBYBY kneel BBBGG pight BBYBB gavel
Solution for lapel: trace BBYBY kneel BBBGG pight YBBBB lapel
Solution for alley: trace BBYBY kneel BBBGY alley
Solution for abled: trace BBYBY kneel BBBGY alley GBGGB abled
Solution for omega: trace BBYBY kneel BBGBB omega
Solution for ahead: trace BBYBY kneel BBGBB omega BBGBY ahead
Solution for ideal: trace BBYBY kneel BBGBG ideal
Solution for plead: trace BBYBY kneel BBGBY plead
Solution for gleam: trace BBYBY kneel BBGBY plead BGGGB gleam
Solution for sepia: trace BBYBY kneel BBYBB sepia
Solution for media: trace BBYBY kneel BBYBB sepia BGBGG media
Solution for essay: trace BBYBY kneel BBYBB sepia YYBBY essay
Solution for pedal: trace BBYBY kneel BBYBG pedal
Solution for legal: trace BBYBY kneel BBYBG pedal BGBGG legal
Solution for medal: trace BBYBY kneel BBYBG pedal BGGGG medal
Solution for equal: trace BBYBY kneel BBYBG pedal BYBGG equal
Solution for fella: trace BBYBY kneel BBYBY fella
Solution for delay: trace BBYBY kneel BBYBY fella BGGBY delay
Solution for easel: trace BBYBY kneel BBYGG easel
Solution for annex: trace BBYBY kneel BGBGB annex
Solution for angel: trace BBYBY kneel BGBGG angel
Solution for enema: trace BBYBY kneel BGGYB enema
Solution for waxen: trace BBYBY kneel BYBGB waxen
Solution for haven: trace BBYBY kneel BYBGB waxen BGBGG haven
Solution for ashen: trace BBYBY kneel BYBGB waxen BYBGG ashen
Solution for apnea: trace BBYBY kneel BYBGB waxen BYBGY apnea
Solution for panel: trace BBYBY kneel BYBGG panel
Solution for navel: trace BBYBY kneel BYBGG panel BGYGG navel
Solution for laden: trace BBYBY kneel BYBGY laden
Solution for alien: trace BBYBY kneel BYBGY laden YYBGG alien
Solution for hyena: trace BBYBY kneel BYGBB hyena
Solution for amend: trace BBYBY kneel BYGBB hyena BBGGY amend
Solution for glean: trace BBYBY kneel BYGBY glean
Solution for vegan: trace BBYBY kneel BYYBB vegan
Solution for sedan: trace BBYBY kneel BYYBB vegan BGBGG sedan
Solution for began: trace BBYBY kneel BYYBB vegan BGGGG began
Solution for penal: trace BBYBY kneel BYYBG penal
Solution for kebab: trace BBYBY kneel GBYBB kebab
Solution for knead: trace BBYBY kneel GGGBB knead
Solution for askew: trace BBYBY kneel YBBGB askew
Solution for speak: trace BBYBY kneel YBGBB speak
Solution for bleak: trace BBYBY kneel YBGBY bleak
Solution for sneak: trace BBYBY kneel YGGBB sneak
Solution for oaken: trace BBYBY kneel YYBGB oaken
Solution for saucy: trace BBYGB saucy
Solution for fancy: trace BBYGB saucy BGBGG fancy
Solution for lance: trace BBYGG lance
Solution for sauce: trace BBYGG lance BGBGG sauce
Solution for dance: trace BBYGG lance BGGGG dance
Solution for mecca: trace BBYGY mecca
Solution for cabal: trace BBYYB monal BBBGG cabal
Solution for lilac: trace BBYYB monal BBBGY lilac
Solution for iliac: trace BBYYB monal BBBGY lilac YYBGG iliac
Solution for caddy: trace BBYYB monal BBBYB caddy
Solution for cabby: trace BBYYB monal BBBYB caddy GGBBG cabby
Solution for basic: trace BBYYB monal BBBYB caddy YGBBB basic
Solution for wacky: trace BBYYB monal BBBYB caddy YGBBG wacky
Solution for scuba: trace BBYYB monal BBBYB caddy YYBBB scuba
Solution for cavil: trace BBYYB monal BBBYG cavil
Solution for caulk: trace BBYYB monal BBBYY caulk
Solution for canal: trace BBYYB monal BBGGG canal
Solution for canny: trace BBYYB monal BBGYB canny
Solution for candy: trace BBYYB monal BBGYB canny GGGBG candy
Solution for panic: trace BBYYB monal BBGYB canny YGGBB panic
Solution for china: trace BBYYB monal BBYYB china
Solution for cabin: trace BBYYB monal BBYYB china GBYYY cabin
Solution for focal: trace BBYYB monal BGBGG vills BBYBB focal
Solution for local: trace BBYYB monal BGBGG vills BBYYB local
Solution for vocal: trace BBYYB monal BGBGG vills GBYBB vocal
Solution for cocoa: trace BBYYB monal BGBYB cocoa
Solution for cacao: trace BBYYB monal BYBGB cacao
Solution for cloak: trace BBYYB monal BYBGY cloak
Solution for havoc: trace BBYYB monal BYBYB havoc
Solution for canon: trace BBYYB monal BYGYB canon
Solution for bacon: trace BBYYB monal BYYYB bacon
Solution for macaw: trace BBYYB monal GBBGB macaw
Solution for magic: trace BBYYB monal GBBYB magic
Solution for manic: trace BBYYB monal GBGYB manic
Solution for mocha: trace BBYYB monal GGBYB mocha
Solution for macho: trace BBYYB monal GYBYB macho
Solution for sumac: trace BBYYB monal YBBGB sumac
Solution for comma: trace BBYYB monal YGBYB comma
Solution for cache: trace BBYYG zobus BBBBB cache
Solution for cause: trace BBYYG zobus BBBYY cause
Solution for cable: trace BBYYG zobus BBGBB cable
Solution for canoe: trace BBYYG zobus BYBBB canoe
Solution for fecal: trace BBYYY podal BBBGG fecal
Solution for clean: trace BBYYY podal BBBGY clean
Solution for cagey: trace BBYYY podal BBBYB cagey
Solution for camel: trace BBYYY podal BBBYG camel
Solution for decay: trace BBYYY podal BBYGB decay
Solution for decal: trace BBYYY podal BBYGG decal
Solution for ocean: trace BBYYY podal BYBGB ocean
Solution for cameo: trace BBYYY podal BYBYB cameo
Solution for pecan: trace BBYYY podal GBBGB pecan
Solution for cheap: trace BBYYY podal YBBGB cheap
Solution for gruff: trace BGBBB poind BBBBB gruff
Solution for wryly: trace BGBBB poind BBBBB gruff BGBBB wryly
Solution for brush: trace BGBBB poind BBBBB gruff BGGBB brush
Solution for dryly: trace BGBBB poind BBBBY dryly
Solution for wrung: trace BGBBB poind BBBGB wrung
Solution for drunk: trace BGBBB poind BBBGY drunk
Solution for grill: trace BGBBB poind BBGBB skyfs BBBBB grill
Solution for frill: trace BGBBB poind BBGBB skyfs BBBYB frill
Solution for grimy: trace BGBBB poind BBGBB skyfs BBYBB grimy
Solution for krill: trace BGBBB poind BBGBB skyfs BYBBB krill
Solution for brisk: trace BGBBB poind BBGBB skyfs YYBBB brisk
Solution for frisk: trace BGBBB poind BBGBB skyfs YYBYB frisk
Solution for drill: trace BGBBB poind BBGBY drill
Solution for bring: trace BGBBB poind BBGGB yakow BBBBB bring
Solution for wring: trace BGBBB poind BBGGB yakow BBBBY wring
Solution for brink: trace BGBBB poind BBGGB yakow BBYBB brink
Solution for briny: trace BGBBB poind BBGGB yakow YBBBB briny
Solution for grind: trace BGBBB poind BBGGG grind
Solution for drink: trace BGBBB poind BBGGY drink
Solution for druid: trace BGBBB poind BBYBG druid
Solution for growl: trace BGBBB poind BYBBB zimbs BBBBB growl
Solution for gross: trace BGBBB poind BYBBB zimbs BBBBG gross
Solution for brook: trace BGBBB poind BYBBB zimbs BBBYB brook
Solution for groom: trace BGBBB poind BYBBB zimbs BBYBB groom
Solution for broom: trace BGBBB poind BYBBB zimbs BBYYB broom
Solution for brood: trace BGBBB poind BYBBG brood
Solution for drool: trace BGBBB poind BYBBY drool
Solution for dross: trace BGBBB poind BYBBY drool GGGBB dross
Solution for droll: trace BGBBB poind BYBBY drool GGGBG droll
Solution for wrong: trace BGBBB poind BYBGB wrong
Solution for frond: trace BGBBB poind BYBGG frond
Solution for frown: trace BGBBB poind BYBYB unbag BYBBB frown
Solution for grown: trace BGBBB poind BYBYB unbag BYBBY grown
Solution for brown: trace BGBBB poind BYBYB unbag BYYBB brown
Solution for drown: trace BGBBB poind BYBYY drown
Solution for broil: trace BGBBB poind BYYBB broil
Solution for irony: trace BGBBB poind BYYGB irony
Solution for groin: trace BGBBB poind BYYYB groin
Solution for privy: trace BGBBB poind GBGBB privy
Solution for prism: trace BGBBB poind GBGBB privy GGGBB prism
Solution for proof: trace BGBBB poind GYBBB zygon BBBGB proof
Solution for prowl: trace BGBBB poind GYBBB zygon BBBYB prowl
Solution for proxy: trace BGBBB poind GYBBB zygon BYBYB proxy
Solution for proud: trace BGBBB poind GYBBG proud
Solution for prong: trace BGBBB poind GYBGB prong
Solution for prior: trace BGBBB poind GYGBB prior
Solution for primo: trace BGBBB poind GYGBB prior GGGYB primo
Solution for group: trace BGBBB poind YYBBB group
Solution for droop: trace BGBBB poind YYBBY droop
Solution for grime: trace BGBBG ponds BBBBB grime
Solution for bribe: trace BGBBG ponds BBBBB grime BGGBG bribe
Solution for bride: trace BGBBG ponds BBBGB bride
Solution for drive: trace BGBBG ponds BBBYB drive
Solution for urine: trace BGBBG ponds BBYBB urine
Solution for brine: trace BGBBG ponds BBYBB urine BGGGG brine
Solution for broke: trace BGBBG ponds BYBBB zygon BBBYB broke
Solution for grove: trace BGBBG ponds BYBBB zygon BBYYB grove
Solution for froze: trace BGBBG ponds BYBBB zygon YBBYB froze
Solution for erode: trace BGBBG ponds BYBGB erode
Solution for drove: trace BGBBG ponds BYBYB drove
Solution for drone: trace BGBBG ponds BYYYB drone
Solution for prize: trace BGBBG ponds GBBBB prize
Solution for prime: trace BGBBG ponds GBBBB prize GGGBG prime
Solution for prude: trace BGBBG ponds GBBGB prude
Solution for pride: trace BGBBG ponds GBBGB prude GGBGG pride
Solution for prune: trace BGBBG ponds GBYBB prune
Solution for prove: trace BGBBG ponds GYBBB prove
Solution for probe: trace BGBBG ponds GYBBB prove GGGBG probe
Solution for prose: trace BGBBG ponds GYBBY prose
Solution for prone: trace BGBBG ponds GYYBB prone
Solution for gripe: trace BGBBG ponds YBBBB gripe
Solution for grope: trace BGBBG ponds YYBBB grope
Solution for gruel: trace BGBBY defer BBBGY gruel
Solution for grief: trace BGBBY defer BBYGY grief
Solution for brief: trace BGBBY defer BBYGY grief BGGGG brief
Solution for error: trace BGBBY defer BYBBG error
Solution for press: trace BGBBY defer BYBBY press
Solution for preen: trace BGBBY defer BYBGY preen
Solution for green: trace BGBBY defer BYBGY preen BGGGG green
Solution for fresh: trace BGBBY defer BYYBY fresh
Solution for freer: trace BGBBY defer BYYGG freer
Solution for dryer: trace BGBBY defer GBBGG dryer
Solution for drier: trace BGBBY defer GBBGG dryer GGBGG drier
Solution for dried: trace BGBBY defer GBBGY dried
Solution for dress: trace BGBBY defer GYBBY dress
Solution for order: trace BGBBY defer YBBGG order
Solution for pried: trace BGBBY defer YBBGY pried
Solution for fried: trace BGBBY defer YBYGY fried
Solution for greed: trace BGBBY defer YYBGY greed
Solution for breed: trace BGBBY defer YYBGY greed BGGGG breed
Solution for freed: trace BGBBY defer YYYGY freed
Solution for frock: trace BGBGB piccy BBBGB frock
Solution for crock: trace BGBGB piccy BBYGB crock
Solution for brick: trace BGBGB piccy BYBGB brick
Solution for crick: trace BGBGB piccy BYYGB crick
Solution for prick: trace BGBGB piccy GYBGB prick
Solution for price: trace BGBGG price
Solution for wreck: trace BGBGY wreck
Solution for crowd: trace BGBYB spunk BBBBB crowd
Solution for crook: trace BGBYB spunk BBBBG crook
Solution for crony: trace BGBYB spunk BBBGB crony
Solution for crown: trace BGBYB spunk BBBYB crown
Solution for crumb: trace BGBYB spunk BBGBB crumb
Solution for crimp: trace BGBYB spunk BYBBB crimp
Solution for crump: trace BGBYB spunk BYGBB crump
Solution for croup: trace BGBYB spunk BYYBB croup
Solution for cross: trace BGBYB spunk YBBBB cross
Solution for crush: trace BGBYB spunk YBGBB crush
Solution for crisp: trace BGBYB spunk YYBBB crisp
Solution for crepe: trace BGBYG voema BBGBB crepe
Solution for creme: trace BGBYG voema BBGGB creme
Solution for crude: trace BGBYG voema BBYBB crude
Solution for crime: trace BGBYG voema BBYGB crime
Solution for crone: trace BGBYG voema BYYBB crone
Solution for creek: trace BGBYY speld BBGBB creek
Solution for creed: trace BGBYY speld BBGBG creed
Solution for credo: trace BGBYY speld BBGBY credo
Solution for crier: trace BGBYY speld BBYBB crier
Solution for cried: trace BGBYY speld BBYBG cried
Solution for cruel: trace BGBYY speld BBYYB cruel
Solution for creep: trace BGBYY speld BYGBB creep
Solution for cress: trace BGBYY speld YBGBB cress
Solution for brawl: trace BGGBB dings BBBBB brawl
Solution for bravo: trace BGGBB dings BBBBB brawl GGGBB bravo
Solution for brass: trace BGGBB dings BBBBG brass
Solution for brash: trace BGGBB dings BBBBY brash
Solution for gravy: trace BGGBB dings BBBYB gravy
Solution for graph: trace BGGBB dings BBBYB gravy GGGBB graph
Solution for grass: trace BGGBB dings BBBYG grass
Solution for grasp: trace BGGBB dings BBBYY grasp
Solution for prawn: trace BGGBB dings BBYBB prawn
Solution for frank: trace BGGBB dings BBYBB prawn BGGBY frank
Solution for brawn: trace BGGBB dings BBYBB prawn BGGGG brawn
Solution for prank: trace BGGBB dings BBYBB prawn GGGBY prank
Solution for frail: trace BGGBB dings BYBBB frail
Solution for grail: trace BGGBB dings BYBYB grail
Solution for brain: trace BGGBB dings BYYBB brain
Solution for grain: trace BGGBB dings BYYYB grain
Solution for drawl: trace BGGBB dings GBBBB drawl
Solution for drama: trace BGGBB dings GBBBB drawl GGGBB drama
Solution for drawn: trace BGGBB dings GBYBB drawn
Solution for drank: trace BGGBB dings GBYBB drawn GGGBY drank
Solution for drain: trace BGGBB dings GYYBB drain
Solution for fraud: trace BGGBB dings YBBBB fraud
Solution for brand: trace BGGBB dings YBYBB brand
Solution for grand: trace BGGBB dings YBYYB grand
Solution for braid: trace BGGBB dings YYBBB braid
Solution for frame: trace BGGBG kedge BBBBG frame
Solution for brave: trace BGGBG kedge BBBBG frame BGGBG brave
Solution for grave: trace BGGBG kedge BBBYG zuppa BBBBY grave
Solution for grape: trace BGGBG kedge BBBYG zuppa BBBGY grape
Solution for graze: trace BGGBG kedge BBBYG zuppa YBBBY graze
Solution for drape: trace BGGBG kedge BBYBG drape
Solution for grade: trace BGGBG kedge BBYYG grade
Solution for erase: trace BGGBG kedge BYBBG erase
Solution for brake: trace BGGBG kedge YBBBG brake
Solution for drake: trace BGGBG kedge YBYBG drake
Solution for wrack: trace BGGGB wrack
Solution for crack: trace BGGGB wrack BGGGG crack
Solution for grace: trace BGGGG grace
Solution for brace: trace BGGGG grace BGGGG brace
Solution for cramp: trace BGGYB yolks BBBBB cramp
Solution for crass: trace BGGYB yolks BBBBG crass
Solution for crash: trace BGGYB yolks BBBBY crash
Solution for crank: trace BGGYB yolks BBBYB crank
Solution for crawl: trace BGGYB yolks BBYBB crawl
Solution for crazy: trace BGGYB yolks YBBBB crazy
Solution for crave: trace BGGYG zygon BBBBB crave
Solution for crane: trace BGGYG zygon BBBBY crane
Solution for craze: trace BGGYG zygon YBBBB craze
Solution for arbor: trace BGYBB arbor
Solution for array: trace BGYBB arbor GGBBY array
Solution for arson: trace BGYBB arbor GGBGB arson
Solution for armor: trace BGYBB arbor GGBGG armor
Solution for ardor: trace BGYBB arbor GGBGG armor GGBGG ardor
Solution for arrow: trace BGYBB arbor GGBGY arrow
Solution for aroma: trace BGYBB arbor GGBYB aroma
Solution for friar: trace BGYBB arbor YGBBG friar
Solution for organ: trace BGYBB arbor YGBYB organ
Solution for groan: trace BGYBB arbor YGBYB organ YGYGG groan
Solution for urban: trace BGYBB arbor YGGBB urban
Solution for briar: trace BGYBB arbor YGYBG briar
Solution for broad: trace BGYBB arbor YGYYB broad
Solution for arose: trace BGYBG arose
Solution for argue: trace BGYBG arose GGBBG argue
Solution for arise: trace BGYBG arose GGBGG arise
Solution for bread: trace BGYBY bread
Solution for wreak: trace BGYBY bread BGGGB wreak
Solution for freak: trace BGYBY bread BGGGB wreak BGGGG freak
Solution for dread: trace BGYBY bread BGGGG dread
Solution for dream: trace BGYBY bread BGGGY dream
Solution for arena: trace BGYBY bread BGGYB arena
Solution for break: trace BGYBY bread GGGGB break
Solution for croak: trace BGYYB croak
Solution for cream: trace BGYYY cream
Solution for creak: trace BGYYY cream GGGGB creak
Solution for whirl: trace BYBBB sound BBBBB whirl
Solution for girly: trace BYBBB sound BBBBB whirl BBYYY girly
Solution for myrrh: trace BYBBB sound BBBBB whirl BYBGB myrrh
Solution for rigid: trace BYBBB sound BBBBG rigid
Solution for blurb: trace BYBBB sound BBGBB blurb
Solution for quirk: trace BYBBB sound BBYBB myrrh BBBGB quirk
Solution for burly: trace BYBBB sound BBYBB myrrh BYGBB burly
Solution for furry: trace BYBBB sound BBYBB myrrh BYGGB furry
Solution for hurry: trace BYBBB sound BBYBB myrrh BYGGY hurry
Solution for rugby: trace BYBBB sound BBYBB myrrh BYYBB rugby
Solution for murky: trace BYBBB sound BBYBB myrrh GYGBB murky
Solution for lurid: trace BYBBB sound BBYBG lurid
Solution for ruddy: trace BYBBB sound BBYBY ruddy
Solution for forgo: trace BYBBB sound BGBBB ymolt BBYBB forgo
Solution for morph: trace BYBBB sound BGBBB ymolt BYYBB morph
Solution for worry: trace BYBBB sound BGBBB ymolt YBYBB worry
Solution for lorry: trace BYBBB sound BGBBB ymolt YBYYB lorry
Solution for roomy: trace BYBBB sound BGBBB ymolt YYGBB roomy
Solution for world: trace BYBBB sound BGBBG world
Solution for wordy: trace BYBBB sound BGBBY wordy
Solution for rowdy: trace BYBBB sound BGBBY wordy YGYGG rowdy
Solution for dowry: trace BYBBB sound BGBBY wordy YGYYG dowry
Solution for horny: trace BYBBB sound BGBGB horny
Solution for robin: trace BYBBB sound BGBYB robin
Solution for moron: trace BYBBB sound BGBYB robin YGBBG moron
Solution for honor: trace BYBBB sound BGBYB robin YGBBY honor
Solution for donor: trace BYBBB sound BGBYY donor
Solution for rough: trace BYBBB sound BGGBB rough
Solution for gourd: trace BYBBB sound BGGBG gourd
Solution for round: trace BYBBB sound BGGGG round
Solution for mourn: trace BYBBB sound BGGYB mourn
Solution for forum: trace BYBBB sound BGYBB forum
Solution for vigor: trace BYBBB sound BYBBB vigor
Solution for floor: trace BYBBB sound BYBBB vigor BBBGG floor
Solution for glory: trace BYBBB sound BYBBB vigor BBYYY glory
Solution for rigor: trace BYBBB sound BYBBB vigor BGGGG rigor
Solution for ivory: trace BYBBB sound BYBBB vigor YYBYY ivory
Solution for fjord: trace BYBBB sound BYBBG fjord
Solution for hydro: trace BYBBB sound BYBBY hydro
Solution for rhino: trace BYBBB sound BYBGB rhino
Solution for minor: trace BYBBB sound BYBYB minor
Solution for juror: trace BYBBB sound BYYBB juror
Solution for humor: trace BYBBB sound BYYBB juror BGBGG humor
Solution for furor: trace BYBBB sound BYYBB juror BGGGG furor
Solution for rumor: trace BYBBB sound BYYBB juror BGYGG rumor
Solution for flour: trace BYBBB sound BYYBB juror BYBYG flour
Solution for smirk: trace BYBBB sound GBBBB smirk
Solution for swirl: trace BYBBB sound GBBBB smirk GBGGB swirl
Solution for shirk: trace BYBBB sound GBBBB smirk GBGGG shirk
Solution for sprig: trace BYBBB sound GBBBB smirk GBYYB sprig
Solution for slurp: trace BYBBB sound GBGBB slurp
Solution for spurn: trace BYBBB sound GBGYB spurn
Solution for shrug: trace BYBBB sound GBYBB shrug
Solution for syrup: trace BYBBB sound GBYBB shrug GBGGB syrup
Solution for surly: trace BYBBB sound GBYBB shrug GBGYB surly
Solution for shrub: trace BYBBB sound GBYBB shrug GGGGB shrub
Solution for sorry: trace BYBBB sound GGBBB sorry
Solution for sword: trace BYBBB sound GYBBG sword
Solution for sworn: trace BYBBB sound GYBYB sworn
Solution for shorn: trace BYBBB sound GYBYB sworn GBGGG shorn
Solution for risky: trace BYBBB sound YBBBB risky
Solution for usurp: trace BYBBB sound YBGBB usurp
Solution for virus: trace BYBBB sound YBYBB virus
Solution for visor: trace BYBBB sound YYBBB visor
Solution for verve: trace BYBBG sprog BBGBB verve
Solution for eerie: trace BYBBG sprog BBGBB verve BGGBG eerie
Solution for nerve: trace BYBBG sprog BBGBB verve BGGGG nerve
Solution for verge: trace BYBBG sprog BBGBY verge
Solution for dirge: trace BYBBG sprog BBGBY verge BBGGG dirge
Solution for merge: trace BYBBG sprog BBGBY verge BGGGG merge
Solution for horde: trace BYBBG sprog BBGYB horde
Solution for borne: trace BYBBG sprog BBGYB horde BGGBG borne
Solution for gorge: trace BYBBG sprog BBGYY gorge
Solution for forge: trace BYBBG sprog BBGYY gorge BGGGG forge
Solution for where: trace BYBBG sprog BBYBB where
Solution for rifle: trace BYBBG sprog BBYBB where BBBYG rifle
Solution for revue: trace BYBBG sprog BBYBB where BBYYG revue
Solution for rhyme: trace BYBBG sprog BBYBB where BGBYG rhyme
Solution for ridge: trace BYBBG sprog BBYBY ridge
Solution for genre: trace BYBBG sprog BBYBY ridge YBBYG genre
Solution for ombre: trace BYBBG sprog BBYYB ombre
Solution for rouge: trace BYBBG sprog BBYYY rouge
Solution for rogue: trace BYBBG sprog BBYYY rouge GGYYG rogue
Solution for puree: trace BYBBG sprog BYGBB puree
Solution for purge: trace BYBBG sprog BYGBY purge
Solution for rupee: trace BYBBG sprog BYYBB rupee
Solution for serve: trace BYBBG sprog GBGBB serve
Solution for surge: trace BYBBG sprog GBGBY surge
Solution for shire: trace BYBBG sprog GBYBB shire
Solution for swore: trace BYBBG sprog GBYYB yrneh BYBYB swore
Solution for shore: trace BYBBG sprog GBYYB yrneh BYBYY shore
Solution for snore: trace BYBBG sprog GBYYB yrneh BYYYB snore
Solution for spree: trace BYBBG sprog GGGBB spree
Solution for spire: trace BYBBG sprog GGYBB spire
Solution for spore: trace BYBBG sprog GGYYB spore
Solution for verse: trace BYBBG sprog YBGBB verse
Solution for nurse: trace BYBBG sprog YBGBB verse BBGGG nurse
Solution for worse: trace BYBBG sprog YBGYB worse
Solution for horse: trace BYBBG sprog YBGYB worse BGGGG horse
Solution for rinse: trace BYBBG sprog YBYBB rinse
Solution for reuse: trace BYBBG sprog YBYBB rinse GBBGG reuse
Solution for rouse: trace BYBBG sprog YBYYB rouse
Solution for purse: trace BYBBG sprog YYGBB purse
Solution for refer: trace BYBBY sinew BBBGB lumpy BBBBB roved GBBGB refer
Solution for roger: trace BYBBY sinew BBBGB lumpy BBBBB roved GGBGB roger
Solution for rodeo: trace BYBBY sinew BBBGB lumpy BBBBB roved GGBGY rodeo
Solution for rover: trace BYBBY sinew BBBGB lumpy BBBBB roved GGGGB rover
Solution for defer: trace BYBBY sinew BBBGB lumpy BBBBB roved YBBGY defer
Solution for fever: trace BYBBY sinew BBBGB lumpy BBBBB roved YBGGB fever
Solution for joker: trace BYBBY sinew BBBGB lumpy BBBBB roved YGBGB joker
Solution for boxer: trace BYBBY sinew BBBGB lumpy BBBBB roved YGBGB joker BGBGG boxer
Solution for hover: trace BYBBY sinew BBBGB lumpy BBBBB roved YGGGB hover
Solution for offer: trace BYBBY sinew BBBGB lumpy BBBBB roved YYBGB offer
Solution for odder: trace BYBBY sinew BBBGB lumpy BBBBB roved YYBGY odder
Solution for foyer: trace BYBBY sinew BBBGB lumpy BBBBY foyer
Solution for poker: trace BYBBY sinew BBBGB lumpy BBBYB poker
Solution for hyper: trace BYBBY sinew BBBGB lumpy BBBYY hyper
Solution for homer: trace BYBBY sinew BBBGB lumpy BBGBB homer
Solution for mover: trace BYBBY sinew BBBGB lumpy BBYBB mover
Solution for ember: trace BYBBY sinew BBBGB lumpy BBYBB mover YBBGG ember
Solution for ruder: trace BYBBY sinew BBBGB lumpy BGBBB ruder
Solution for queer: trace BYBBY sinew BBBGB lumpy BGBBB ruder BGBGG queer
Solution for buyer: trace BYBBY sinew BBBGB lumpy BGBBY buyer
Solution for purer: trace BYBBY sinew BBBGB lumpy BGBYB purer
Solution for udder: trace BYBBY sinew BBBGB lumpy BYBBB udder
Solution for upper: trace BYBBY sinew BBBGB lumpy BYBYB upper
Solution for lover: trace BYBBY sinew BBBGB lumpy GBBBB lover
Solution for lever: trace BYBBY sinew BBBGB lumpy GBBBB lover GBGGG lever
Solution for leper: trace BYBBY sinew BBBGB lumpy GBBYB leper
Solution for revel: trace BYBBY sinew BBBGB lumpy YBBBB revel
Solution for rebel: trace BYBBY sinew BBBGB lumpy YBBBB revel GGBGG rebel
Solution for older: trace BYBBY sinew BBBGB lumpy YBBBB revel YBBGY older
Solution for elder: trace BYBBY sinew BBBGB lumpy YBBBB revel YYBGY elder
Solution for flyer: trace BYBBY sinew BBBGB lumpy YBBBY flyer
Solution for repel: trace BYBBY sinew BBBGB lumpy YBBYB repel
Solution for ruler: trace BYBBY sinew BBBGB lumpy YGBBB ruler
Solution for bluer: trace BYBBY sinew BBBGB lumpy YYBBB bluer
Solution for fewer: trace BYBBY sinew BBBGY clomp BBBBB fewer
Solution for wooer: trace BYBBY sinew BBBGY clomp BBGBB wooer
Solution for rower: trace BYBBY sinew BBBGY clomp BBYBB rower
Solution for power: trace BYBBY sinew BBBGY clomp BBYBY power
Solution for mower: trace BYBBY sinew BBBGY clomp BBYYB mower
Solution for lower: trace BYBBY sinew BBBGY clomp BYYBB lower
Solution for berry: trace BYBBY sinew BBBYB medle BGBBB fjord BBBGB berry
Solution for perky: trace BYBBY sinew BBBYB medle BGBBB fjord BBBYB perky
Solution for jerky: trace BYBBY sinew BBBYB medle BGBBB fjord BYBYB jerky
Solution for ferry: trace BYBBY sinew BBBYB medle BGBBB fjord GBBGB ferry
Solution for reply: trace BYBBY sinew BBBYB medle BGBGB reply
Solution for leery: trace BYBBY sinew BBBYB medle BGBYY leery
Solution for derby: trace BYBBY sinew BBBYB medle BGYBB derby
Solution for reedy: trace BYBBY sinew BBBYB medle BGYBY reedy
Solution for query: trace BYBBY sinew BBBYB medle BYBBB query
Solution for every: trace BYBBY sinew BBBYB medle BYBBY every
Solution for merry: trace BYBBY sinew BBBYB medle GGBBB merry
Solution for femur: trace BYBBY sinew BBBYB medle YGBBB femur
Solution for lemur: trace BYBBY sinew BBBYB medle YGBYB lemur
Solution for demur: trace BYBBY sinew BBBYB medle YGYBB demur
Solution for goner: trace BYBBY sinew BBGGB goner
Solution for renew: trace BYBBY sinew BBGGG renew
Solution for owner: trace BYBBY sinew BBGGY owner
Solution for under: trace BYBBY sinew BBYGB under
Solution for never: trace BYBBY sinew BBYGB under BYBGG never
Solution for newer: trace BYBBY sinew BBYGY newer
Solution for rerun: trace BYBBY sinew BBYYB rerun
Solution for heron: trace BYBBY sinew BBYYB rerun BGGBG heron
Solution for nerdy: trace BYBBY sinew BBYYB rerun BGGBY nerdy
Solution for riper: trace BYBBY sinew BGBGB voled BBBGB refix GYBYB riper
Solution for piper: trace BYBBY sinew BGBGB voled BBBGB refix YYBYB piper
Solution for fiber: trace BYBBY sinew BGBGB voled BBBGB refix YYYYB fiber
Solution for fixer: trace BYBBY sinew BGBGB voled BBBGB refix YYYYY fixer
Solution for rider: trace BYBBY sinew BGBGB voled BBBGY rider
Solution for filer: trace BYBBY sinew BGBGB voled BBGGB filer
Solution for viper: trace BYBBY sinew BGBGB voled GBBGB viper
Solution for river: trace BYBBY sinew BGBGB voled YBBGB river
Solution for giver: trace BYBBY sinew BGBGB voled YBBGB river BGGGG giver
Solution for diver: trace BYBBY sinew BGBGB voled YBBGY diver
Solution for liver: trace BYBBY sinew BGBGB voled YBYGB liver
Solution for wider: trace BYBBY sinew BGBGY wider
Solution for fiery: trace BYBBY sinew BGBYB fiery
Solution for finer: trace BYBBY sinew BGGGB muled BBBGB finer
Solution for diner: trace BYBBY sinew BGGGB muled BBBGY diner
Solution for liner: trace BYBBY sinew BGGGB muled BBYGB liner
Solution for miner: trace BYBBY sinew BGGGB muled GBBGB miner
Solution for ripen: trace BYBBY sinew BGYGB ripen
Solution for plier: trace BYBBY sinew BYBGB plier
Solution for flier: trace BYBBY sinew BYBGB plier BGGGG flier
Solution for idler: trace BYBBY sinew BYBGB plier BYYGG idler
Solution for peril: trace BYBBY sinew BYBYB peril
Solution for weird: trace BYBBY sinew BYBYY weird
Solution for inner: trace BYBBY sinew BYGGB inner
Solution for infer: trace BYBBY sinew BYYGB infer
Solution for reign: trace BYBBY sinew BYYYB reign
Solution for surer: trace BYBBY sinew GBBGB shrub GBGYB surer
Solution for sever: trace BYBBY sinew GBBGB shrub GBYBB sever
Solution for sober: trace BYBBY sinew GBBGB shrub GBYBY sober
Solution for super: trace BYBBY sinew GBBGB shrub GBYYB super
Solution for sheer: trace BYBBY sinew GBBGB shrub GGYBB sheer
Solution for shrew: trace BYBBY sinew GBBGG shrew
Solution for sower: trace BYBBY sinew GBBGY sower
Solution for sewer: trace BYBBY sinew GBBGY sower GBGGG sewer
Solution for sperm: trace BYBBY sinew GBBYB sperm
Solution for serum: trace BYBBY sinew GBBYB sperm GBYYG serum
Solution for sneer: trace BYBBY sinew GBYGB sneer
Solution for siren: trace BYBBY sinew GGYGB siren
Solution for skier: trace BYBBY sinew GYBGB skier
Solution for serif: trace BYBBY sinew GYBYB serif
Solution for poser: trace BYBBY sinew YBBGB poser
Solution for usher: trace BYBBY sinew YBBGB poser BBYGG usher
Solution for loser: trace BYBBY sinew YBBGB poser BGGGG loser
Solution for verso: trace BYBBY sinew YBBYB verso
Solution for rebus: trace BYBBY sinew YBBYB verso BGYYB rebus
Solution for riser: trace BYBBY sinew YGBGB riser
Solution for miser: trace BYBBY sinew YGBGB riser BGGGG miser
Solution for wiser: trace BYBBY sinew YGBGY wiser
Solution for risen: trace BYBBY sinew YGYGB risen
Solution for resin: trace BYBBY sinew YYYYB resin
Solution for porch: trace BYBGB zuzim BBBBB porch
Solution for birch: trace BYBGB zuzim BBBYB birch
Solution for lurch: trace BYBGB zuzim BGBBB lurch
Solution for force: trace BYBGG force
Solution for perch: trace BYBGY perch
Solution for mercy: trace BYBGY perch BGGGB mercy
Solution for choir: trace BYBYB choir
Solution for curry: trace BYBYB choir GBBBY wolve BBBBB curry
Solution for curvy: trace BYBYB choir GBBBY wolve BBBGB curvy
Solution for curly: trace BYBYB choir GBBBY wolve BBYBB curly
Solution for color: trace BYBYB choir GBYBG color
Solution for corny: trace BYBYB choir GBYBY corny
Solution for curio: trace BYBYB choir GBYGY curio
Solution for churn: trace BYBYB choir GGBBY churn
Solution for chirp: trace BYBYB choir GGBYY chirp
Solution for chord: trace BYBYB choir GGGBY chord
Solution for scrum: trace BYBYB choir YBBBY scrum
Solution for scrub: trace BYBYB choir YBBBY scrum GGGGB scrub
Solution for lyric: trace BYBYB choir YBBGY lyric
Solution for incur: trace BYBYB choir YBBYG incur
Solution for scour: trace BYBYB choir YBGBG scour
Solution for scorn: trace BYBYB choir YBGBY scorn
Solution for occur: trace BYBYB choir YBYBG occur
Solution for rocky: trace BYBYB choir YBYBY rocky
Solution for micro: trace BYBYB choir YBYYY micro
Solution for scree: trace BYBYG scree
Solution for curve: trace BYBYG scree BYGBG curve
Solution for chore: trace BYBYG scree BYYBG chore
Solution for score: trace BYBYG scree GGYBG score
Solution for curse: trace BYBYG scree YYGBG curse
Solution for ulcer: trace BYBYY ricer BBGGG ulcer
Solution for decor: trace BYBYY ricer BBGYG decor
Solution for cyber: trace BYBYY ricer BBYGG zowee BBBGB cyber
Solution for cheer: trace BYBYY ricer BBYGG zowee BBBGY cheer
Solution for cover: trace BYBYY ricer BBYGG zowee BGBGB cover
Solution for cower: trace BYBYY ricer BBYGG zowee BGGGB cower
Solution for nicer: trace BYBYY ricer BGGGG nicer
Solution for cider: trace BYBYY ricer BGYGG cider
Solution for recur: trace BYBYY ricer GBGYG recur
Solution for relic: trace BYBYY ricer GYYYB relic
Solution for decry: trace BYBYY ricer YBGYB decry
Solution for screw: trace BYBYY ricer YBYGB screw
Solution for corer: trace BYBYY ricer YBYGG corer
Solution for clerk: trace BYBYY ricer YBYYB clerk
Solution for quark: trace BYGBB showd BBBBB quark
Solution for alarm: trace BYGBB showd BBBBB quark BBGGB alarm
Solution for flair: trace BYGBB showd BBBBB quark BBGYB flair
Solution for guard: trace BYGBB showd BBBBG guard
Solution for diary: trace BYGBB showd BBBBY diary
Solution for award: trace BYGBB showd BBBYG award
Solution for dwarf: trace BYGBB showd BBBYY dwarf
Solution for ovary: trace BYGBB showd BBYBB ovary
Solution for board: trace BYGBB showd BBYBG board
Solution for wharf: trace BYGBB showd BGBYB wharf
Solution for hoard: trace BYGBB showd BYYBG hoard
Solution for spark: trace BYGBB showd GBBBB spark
Solution for snarl: trace BYGBB showd GBBBB spark GBGGB snarl
Solution for swarm: trace BYGBB showd GBBYB swarm
Solution for sharp: trace BYGBB showd GGBBB sharp
Solution for shark: trace BYGBB showd GGBBB sharp GGGGB shark
Solution for shard: trace BYGBB showd GGBBG shard
Solution for flare: trace BYGBG wings BBBBB flare
Solution for blare: trace BYGBG wings BBBBB flare BGGGG blare
Solution for spare: trace BYGBG wings BBBBY spare
Solution for share: trace BYGBG wings BBBBY spare GBGGG share
Solution for glare: trace BYGBG wings BBBYB glare
Solution for snare: trace BYGBG wings BBYBY snare
Solution for aware: trace BYGBG wings YBBBB aware
Solution for rearm: trace BYGBY reply GGBBB rearm
Solution for ready: trace BYGBY reply GGBBG ready
Solution for realm: trace BYGBY reply GGBGB realm
Solution for heard: trace BYGBY reply YGBBB heard
Solution for beard: trace BYGBY reply YGBBB heard BGGGG beard
Solution for weary: trace BYGBY reply YGBBG weary
Solution for yearn: trace BYGBY reply YGBBY yearn
Solution for learn: trace BYGBY reply YGBYB learn
Solution for pearl: trace BYGBY reply YGYYB pearl
Solution for roach: trace BYGGB roach
Solution for reach: trace BYGGY reach
Solution for charm: trace BYGYB yirds BBYBB charm
Solution for scarf: trace BYGYB yirds BBYBY scarf
Solution for chard: trace BYGYB yirds BBYYB chard
Solution for chair: trace BYGYB yirds BYYBB chair
Solution for scary: trace BYGYB yirds YBYBY scary
Solution for scare: trace BYGYG scare
Solution for radar: trace BYYBB pylon BBBBB radar
Solution for sugar: trace BYYBB pylon BBBBB radar BBBGG sugar
Solution for augur: trace BYYBB pylon BBBBB radar BYBBG augur
Solution for rabbi: trace BYYBB pylon BBBBB radar GGBBB rabbi
Solution for rajah: trace BYYBB pylon BBBBB radar GGBGB rajah
Solution for radii: trace BYYBB pylon BBBBB radar GGGBB radii
Solution for rabid: trace BYYBB pylon BBBBB radar GGYBB rabid
Solution for rumba: trace BYYBB pylon BBBBB radar GYBBB rumba
Solution for marsh: trace BYYBB pylon BBBBB radar YGBBB marsh
Solution for harsh: trace BYYBB pylon BBBBB radar YGBBB marsh BGGGG harsh
Solution for karma: trace BYYBB pylon BBBBB radar YGBYB karma
Solution for umbra: trace BYYBB pylon BBBBB radar YYBBB umbra
Solution for nadir: trace BYYBB pylon BBBBY nadir
Solution for favor: trace BYYBB pylon BBBGB zimbs BBBBB favor
Solution for savor: trace BYYBB pylon BBBGB zimbs BBBBY savor
Solution for abhor: trace BYYBB pylon BBBGB zimbs BBBYB abhor
Solution for major: trace BYYBB pylon BBBGB zimbs BBYBB major
Solution for razor: trace BYYBB pylon BBBGB zimbs YBBBB razor
Solution for baron: trace BYYBB pylon BBBGG baron
Solution for manor: trace BYYBB pylon BBBGY manor
Solution for radio: trace BYYBB pylon BBBYB radio
Solution for borax: trace BYYBB pylon BBBYB radio YYBBY borax
Solution for adorn: trace BYYBB pylon BBBYG adorn
Solution for sonar: trace BYYBB pylon BBBYY sonar
Solution for valor: trace BYYBB pylon BBGGB valor
Solution for solar: trace BYYBB pylon BBGYB solar
Solution for molar: trace BYYBB pylon BBGYB solar BGGGG molar
Solution for rural: trace BYYBB pylon BBYBB rural
Solution for viral: trace BYYBB pylon BBYBB rural BBGGG viral
Solution for larva: trace BYYBB pylon BBYBB rural BBGYY larva
Solution for mural: trace BYYBB pylon BBYBB rural BGGGG mural
Solution for rival: trace BYYBB pylon BBYBB rural GBBGG rival
Solution for lunar: trace BYYBB pylon BBYBY lunar
Solution for labor: trace BYYBB pylon BBYGB labor
Solution for moral: trace BYYBB pylon BBYYB moral
Solution for flora: trace BYYBB pylon BBYYB moral BYYYY flora
Solution for hardy: trace BYYBB pylon BYBBB hardy
Solution for marry: trace BYYBB pylon BYBBB hardy BGGBG marry
Solution for fairy: trace BYYBB pylon BYBBB hardy BGYBG fairy
Solution for dairy: trace BYYBB pylon BYBBB hardy BGYYG dairy
Solution for harry: trace BYYBB pylon BYBBB hardy GGGBG harry
Solution for hairy: trace BYYBB pylon BYBBB hardy GGYBG hairy
Solution for randy: trace BYYBB pylon BYBBY randy
Solution for rainy: trace BYYBB pylon BYBBY randy GGYBG rainy
Solution for angry: trace BYYBB pylon BYBBY randy YYYBG angry
Solution for mayor: trace BYYBB pylon BYBGB mayor
Solution for rayon: trace BYYBB pylon BYBGG rayon
Solution for foray: trace BYYBB pylon BYBYB foray
Solution for rally: trace BYYBB pylon BYGBB rally
Solution for royal: trace BYYBB pylon BYYYB royal
Solution for parka: trace BYYBB pylon GBBBB parka
Solution for polar: trace BYYBB pylon GBGYB polar
Solution for parry: trace BYYBB pylon GYBBB parry
Solution for rapid: trace BYYBB pylon YBBBB rapid
Solution for vapor: trace BYYBB pylon YBBGB vapor
Solution for apron: trace BYYBB pylon YBBGG apron
Solution for ralph: trace BYYBB pylon YBGBB ralph
Solution for spray: trace BYYBB pylon YYBBB spray
Solution for harpy: trace BYYBB pylon YYBBB spray BYGYG harpy
Solution for raspy: trace BYYBB pylon YYBBB spray YYYYG raspy
Solution for adore: trace BYYBG zings BBBBB adore
Solution for parse: trace BYYBG zings BBBBY parse
Solution for large: trace BYYBG zings BBBGB large
Solution for barge: trace BYYBG zings BBBGB large BGGGG barge
Solution for agree: trace BYYBG zings BBBYB agree
Solution for range: trace BYYBG zings BBGGB range
Solution for afire: trace BYYBG zings BYBBB afire
Solution for raise: trace BYYBG zings BYBBY raise
Solution for azure: trace BYYBG zings YBBBB azure
Solution for rehab: trace BYYBY splay BBBGB rehab
Solution for rebar: trace BYYBY splay BBBGB rehab GGBGY rebar
Solution for debar: trace BYYBY splay BBBGB rehab YGBGY debar
Solution for gamer: trace BYYBY splay BBBYB gamer
Solution for rarer: trace BYYBY splay BBBYB gamer BGBGG wakfs BGBBB rarer
Solution for baker: trace BYYBY splay BBBYB gamer BGBGG wakfs BGGBB baker
Solution for waver: trace BYYBY splay BBBYB gamer BGBGG wakfs GGBBB waver
Solution for wafer: trace BYYBY splay BBBYB gamer BGBGG wakfs GGBYB wafer
Solution for raven: trace BYYBY splay BBBYB gamer BGBGY raven
Solution for ramen: trace BYYBY splay BBBYB gamer BGGGY ramen
Solution for maker: trace BYYBY splay BBBYB gamer BGYGG maker
Solution for harem: trace BYYBY splay BBBYB gamer BGYGY harem
Solution for aider: trace BYYBY splay BBBYB gamer BYBGG aider
Solution for zebra: trace BYYBY splay BBBYB gamer BYBYY zebra
Solution for amber: trace BYYBY splay BBBYB gamer BYYGG amber
Solution for gazer: trace BYYBY splay BBBYB gamer GGBGG gazer
Solution for wager: trace BYYBY splay BBBYB gamer YGBGG wager
Solution for eager: trace BYYBY splay BBBYB gamer YGBGG wager BGGGG eager
Solution for anger: trace BYYBY splay BBBYB gamer YYBGG anger
Solution for gayer: trace BYYBY splay BBBYY gayer
Solution for relax: trace BYYBY splay BBGGB relax
Solution for relay: trace BYYBY splay BBGGG relay
Solution for baler: trace BYYBY splay BBGYB baler
Solution for renal: trace BYYBY splay BBYGB renal
Solution for regal: trace BYYBY splay BBYGB renal GGBGG regal
Solution for feral: trace BYYBY splay BBYGB renal YGBGG feral
Solution for lager: trace BYYBY splay BBYYB lager
Solution for early: trace BYYBY splay BBYYG early
Solution for layer: trace BYYBY splay BBYYY layer
Solution for opera: trace BYYBY splay BGBYB opera
Solution for repay: trace BYYBY splay BYBGG repay
Solution for parer: trace BYYBY splay BYBYB parer
Solution for paper: trace BYYBY splay BYBYB parer GGBGG paper
Solution for payer: trace BYYBY splay BYBYY payer
Solution for paler: trace BYYBY splay BYGYB paler
Solution for swear: trace BYYBY splay GBBGB zhomo BBBBB swear
Solution for smear: trace BYYBY splay GBBGB zhomo BBBYB smear
Solution for shear: trace BYYBY splay GBBGB zhomo BGBBB shear
Solution for saner: trace BYYBY splay GBBYB saner
Solution for safer: trace BYYBY splay GBBYB saner GGBGG safer
Solution for spear: trace BYYBY splay GGBGB spear
Solution for ranch: trace BYYGB ranch
Solution for march: trace BYYGB ranch YGBGG march
Solution for circa: trace BYYGB ranch YYBGB circa
Solution for farce: trace BYYGG farce
Solution for carry: trace BYYYB coram GBGYB carry
Solution for cigar: trace BYYYB coram GBYGB cigar
Solution for cairn: trace BYYYB coram GBYYB cairn
Solution for coral: trace BYYYB coram GGGGB coral
Solution for cobra: trace BYYYB coram GGYYB cobra
Solution for carol: trace BYYYB coram GYGYB carol
Solution for cargo: trace BYYYB coram GYGYB carol GGGYB cargo
Solution for scrap: trace BYYYB coram YBGGB scrap
Solution for scram: trace BYYYB coram YBGGG scram
Solution for acrid: trace BYYYB coram YBGYB acrid
Solution for vicar: trace BYYYB coram YBYGB vicar
Solution for acorn: trace BYYYB coram YYYYB acorn
Solution for macro: trace BYYYB coram YYYYY macro
Solution for carve: trace BYYYG carve
Solution for recap: trace BYYYY recap
Solution for racer: trace BYYYY recap GYGYB racer
Solution for cedar: trace BYYYY recap YGYGB cedar
Solution for clear: trace BYYYY recap YYYGB clear
Solution for caper: trace BYYYY recap YYYYY caper
Solution for thump: trace GBBBB yogin BBBBB thump
Solution for thumb: trace GBBBB yogin BBBBB thump GGGGB thumb
Solution for tulip: trace GBBBB yogin BBBGB tulip
Solution for timid: trace GBBBB yogin BBBGB tulip GBBGB timid
Solution for twixt: trace GBBBB yogin BBBYB twixt
Solution for twist: trace GBBBB yogin BBBYB twixt GGGBG twist
Solution for think: trace GBBBB yogin BBBYY think
Solution for tight: trace GBBBB yogin BBGYB tight
Solution for thigh: trace GBBBB yogin BBYYB thigh
Solution for thing: trace GBBBB yogin BBYYY thing
Solution for tooth: trace GBBBB yogin BGBBB tooth
Solution for toxin: trace GBBBB yogin BGBGG toxin
Solution for tough: trace GBBBB yogin BGYBB tough
Solution for thong: trace GBBBB yogin BYYBY thong
Solution for tipsy: trace GBBBB yogin YBBYB tipsy
Solution for tying: trace GBBBB yogin YBYYY tying
Solution for toddy: trace GBBBB yogin YGBBB toddy
Solution for tepee: trace GBBBG shily BBBBB tepee
Solution for tulle: trace GBBBG shily BBBGB tulle
Solution for twine: trace GBBBG shily BBGBB twine
Solution for title: trace GBBBG shily BBYGB title
Solution for tilde: trace GBBBG shily BBYYB tilde
Solution for theme: trace GBBBG shily BGBBB theme
Solution for thyme: trace GBBBG shily BGBBY thyme
Solution for tithe: trace GBBBG shily BYYBB tithe
Solution for tense: trace GBBBG shily YBBBB tense
Solution for those: trace GBBBG shily YGBBB those
Solution for these: trace GBBBG shily YGBBB those GGBGG these
Solution for towel: trace GBBBY mened BBBGB towel
Solution for thief: trace GBBBY mened BBBGB towel GBBGB thief
Solution for token: trace GBBBY mened BBYGB token
Solution for testy: trace GBBBY mened BGBBB testy
Solution for tepid: trace GBBBY mened BGBBG tepid
Solution for teddy: trace GBBBY mened BGBBY teddy
Solution for teeth: trace GBBBY mened BGBYB teeth
Solution for tenth: trace GBBBY mened BGGBB tenth
Solution for tenet: trace GBBBY mened BGGGB tenet
Solution for theft: trace GBBBY mened BYBBB theft
Solution for tweet: trace GBBBY mened BYBGB tweet
Solution for tweed: trace GBBBY mened BYBGG tweed
Solution for totem: trace GBBBY mened YBBGB totem
Solution for tempo: trace GBBBY mened YGBBB tempo
Solution for touch: trace GBBGB touch
Solution for thick: trace GBBGB touch GBBGY thick
Solution for twice: trace GBBGG twice
Solution for toxic: trace GBBYB zupan BBBBB toxic
Solution for tonic: trace GBBYB zupan BBBBY tonic
Solution for topic: trace GBBYB zupan BBGBB topic
Solution for tunic: trace GBBYB zupan BGBBY tunic
Solution for twang: trace GBGBB twang
Solution for toast: trace GBGBB twang GBGBB toast
Solution for thank: trace GBGBB twang GBGGB thank
Solution for tease: trace GBGBG tease
Solution for teach: trace GBGGY teach
Solution for tatty: trace GBYBB noily BBBBG yufts YBBGB tatty
Solution for tasty: trace GBYBB noily BBBBG yufts YBBGY tasty
Solution for tabby: trace GBYBB noily BBBBG yufts YBBYB tabby
Solution for taffy: trace GBYBB noily BBBBG yufts YBGYB taffy
Solution for tally: trace GBYBB noily BBBGG tally
Solution for tubal: trace GBYBB noily BBBYB tubal
Solution for tibia: trace GBYBB noily BBYBB tibia
Solution for tidal: trace GBYBB noily BBYYB tidal
Solution for topaz: trace GBYBB noily BGBBB topaz
Solution for today: trace GBYBB noily BGBBG today
Solution for total: trace GBYBB noily BGBYB total
Solution for taboo: trace GBYBB noily BYBBB taboo
Solution for taunt: trace GBYBB noily YBBBB taunt
Solution for tawny: trace GBYBB noily YBBBG tawny
Solution for tangy: trace GBYBB noily YBBBG tawny GGBYG tangy
Solution for taint: trace GBYBB noily YBGBB taint
Solution for titan: trace GBYBB noily YBYBB titan
Solution for tonga: trace GBYBB noily YGBBB tonga
Solution for tonal: trace GBYBB noily YGBYB tonal
Solution for tango: trace GBYBB noily YYBBB tango
Solution for talon: trace GBYBB noily YYBYB talon
Solution for taste: trace GBYBG taste
Solution for table: trace GBYBG taste GGBBG table
Solution for tweak: trace GBYBY tweak
Solution for theta: trace GBYBY tweak GBGYB theta
Solution for taken: trace GBYBY tweak GBYYY taken
Solution for tacky: trace GBYYB tacky
Solution for tacit: trace GBYYB tacky GGGBB tacit
Solution for troop: trace GGBBB yukos BBBGB troop
Solution for troll: trace GGBBB yukos BBBYB troll
Solution for truth: trace GGBBB yukos BYBBB truth
Solution for trump: trace GGBBB yukos BYBBB truth GGGBB trump
Solution for truss: trace GGBBB yukos BYBBG truss
Solution for trust: trace GGBBB yukos BYBBY trust
Solution for trout: trace GGBBB yukos BYBYB trout
Solution for trunk: trace GGBBB yukos BYYBB trunk
Solution for tryst: trace GGBBB yukos YBBBY tryst
Solution for truly: trace GGBBB yukos YYBBB truly
Solution for trite: trace GGBBG upbow BBBBB trite
Solution for trove: trace GGBBG upbow BBBYB trove
Solution for tribe: trace GGBBG upbow BBYBB tribe
Solution for tripe: trace GGBBG upbow BYBBB tripe
Solution for trope: trace GGBBG upbow BYBYB trope
Solution for truer: trace GGBBY truer
Solution for tried: trace GGBBY truer GGBGB tried
Solution for trend: trace GGBBY truer GGBYB trend
Solution for truck: trace GGBGB truck
Solution for trick: trace GGBGB truck GGBGG trick
Solution for truce: trace GGBGG truce
Solution for trice: trace GGBGG truce GGBGG trice
Solution for trash: trace GGGBB uplit BBBBY trash
Solution for trait: trace GGGBB uplit BBBGG trait
Solution for train: trace GGGBB uplit BBBGY train
Solution for trawl: trace GGGBB uplit BBYBY trawl
Solution for trail: trace GGGBB uplit BBYGY trail
Solution for tramp: trace GGGBB uplit BYBBY tramp
Solution for trade: trace GGGBG trade
Solution for tract: trace GGGGB tract
Solution for track: trace GGGGB tract GGGGB track
Solution for trial: trace GGYBB trial
Solution for triad: trace GGYBB trial GGGGB triad
Solution for treat: trace GGYBY treat
Solution for tread: trace GGYBY treat GGGGB tread
Solution for twirl: trace GYBBB butoh BBYBB twirl
Solution for third: trace GYBBB butoh BBYBY third
Solution for throw: trace GYBBB butoh BBYGY throw
Solution for torso: trace GYBBB butoh BBYYB torso
Solution for thorn: trace GYBBB butoh BBYYY thorn
Solution for tutor: trace GYBBB butoh BGGGB tutor
Solution for tumor: trace GYBBB butoh BGYGB tumor
Solution for thrum: trace GYBBB butoh BYYBY thrum
Solution for torus: trace GYBBB butoh BYYYB torus
Solution for throb: trace GYBBB butoh YBYGY throb
Solution for turbo: trace GYBBB butoh YGYYB turbo
Solution for three: trace GYBBG three
Solution for terse: trace GYBBG three GBGYG terse
Solution for there: trace GYBBG three GGYYG there
Solution for tenor: trace GYBBY weigh BGBBB tenor
Solution for tuber: trace GYBBY weigh BYBBB tuber
Solution for timer: trace GYBBY weigh BYYBB timer
Solution for their: trace GYBBY weigh BYYBY their
Solution for tiger: trace GYBBY weigh BYYYB tiger
Solution for tower: trace GYBBY weigh YYBBB tower
Solution for threw: trace GYBBY weigh YYBBY threw
Solution for torch: trace GYBGB torch
Solution for tiara: trace GYGBB tiara
Solution for teary: trace GYGBY teary
Solution for tarot: trace GYYBB tarot
Solution for tardy: trace GYYBB tarot GGGBB tardy
Solution for tapir: trace GYYBB tarot GGYBB tapir
Solution for taker: trace GYYBY ympes BBBGB taker
Solution for terra: trace GYYBY ympes BBBYB terra
Solution for taper: trace GYYBY ympes BBGGB taper
Solution for tamer: trace GYYBY ympes BYBGB tamer
Solution for point: trace YBBBB point
Solution for gusty: trace YBBBB point BBBBY muled BGBBB gusty
Solution for dusty: trace YBBBB point BBBBY muled BGBBY dusty
Solution for lusty: trace YBBBB point BBBBY muled BGYBB lusty
Solution for stuff: trace YBBBB point BBBBY muled BYBBB stuff
Solution for study: trace YBBBB point BBBBY muled BYBBY study
Solution for musty: trace YBBBB point BBBBY muled GGBBB musty
Solution for stunt: trace YBBBB point BBBGG stunt
Solution for blunt: trace YBBBB point BBBGG stunt BBGGG blunt
Solution for shunt: trace YBBBB point BBBGG stunt GBGGG shunt
Solution for stunk: trace YBBBB point BBBGY stunk
Solution for stung: trace YBBBB point BBBGY stunk GGGGB stung
Solution for nutty: trace YBBBB point BBBYY nutty
Solution for quilt: trace YBBBB point BBGBG whigs BBGBB quilt
Solution for built: trace YBBBB point BBGBG whigs BBGBB quilt BGGGG built
Solution for stilt: trace YBBBB point BBGBG whigs BBGBY stilt
Solution for guilt: trace YBBBB point BBGBG whigs BBGYB guilt
Solution for shift: trace YBBBB point BBGBG whigs BGGBY shift
Solution for swift: trace YBBBB point BBGBG whigs YBGBY swift
Solution for still: trace YBBBB point BBGBY still
Solution for blitz: trace YBBBB point BBGBY still BYGYB blitz
Solution for stiff: trace YBBBB point BBGBY still GGGBB stiff
Solution for smith: trace YBBBB point BBGBY still GYGBB smith
Solution for glint: trace YBBBB point BBGGG glint
Solution for stint: trace YBBBB point BBGGG glint BBGGG stint
Solution for flint: trace YBBBB point BBGGG glint BGGGG flint
Solution for stink: trace YBBBB point BBGGY stink
Solution for sting: trace YBBBB point BBGGY stink GGGGB sting
Solution for unity: trace YBBBB point BBGYY unity
Solution for digit: trace YBBBB point BBYBG whims BBYBB digit
Solution for visit: trace YBBBB point BBYBG whims BBYBY visit
Solution for limit: trace YBBBB point BBYBG whims BBYYB limit
Solution for midst: trace YBBBB point BBYBG whims BBYYY midst
Solution for light: trace YBBBB point BBYBG whims BYYBB light
Solution for fight: trace YBBBB point BBYBG whims BYYBB light BGGGG fight
Solution for sight: trace YBBBB point BBYBG whims BYYBY sight
Solution for might: trace YBBBB point BBYBG whims BYYYB might
Solution for wight: trace YBBBB point BBYBG whims GYYBB wight
Solution for width: trace YBBBB point BBYBY yufts BBBGB width
Solution for sixth: trace YBBBB point BBYBY yufts BBBGY sixth
Solution for fifth: trace YBBBB point BBYBY yufts BBGGB fifth
Solution for filth: trace YBBBB point BBYBY yufts BBYGB filth
Solution for bitty: trace YBBBB point BBYBY yufts YBBGB waked BBBBB bitty
Solution for ditty: trace YBBBB point BBYBY yufts YBBGB waked BBBBY ditty
Solution for kitty: trace YBBBB point BBYBY yufts YBBGB waked BBYBB kitty
Solution for witty: trace YBBBB point BBYBY yufts YBBGB waked GBBBB witty
Solution for sixty: trace YBBBB point BBYBY yufts YBBGY sixty
Solution for fifty: trace YBBBB point BBYBY yufts YBGGB fifty
Solution for unlit: trace YBBBB point BBYYG unlit
Solution for night: trace YBBBB point BBYYG unlit BYBYG night
Solution for unfit: trace YBBBB point BBYYG unlit GGBGG unfit
Solution for ninth: trace YBBBB point BBYYY ninth
Solution for minty: trace YBBBB point BBYYY ninth BGGGB minty
Solution for until: trace YBBBB point BBYYY ninth YYBYB until
Solution for boost: trace YBBBB point BGBBG boost
Solution for moult: trace YBBBB point BGBBG boost BGBBG moult
Solution for joust: trace YBBBB point BGBBG boost BGBGG joust
Solution for doubt: trace YBBBB point BGBBG boost YGBBG doubt
Solution for sooty: trace YBBBB point BGBBY sooty
Solution for mouth: trace YBBBB point BGBBY sooty BGBGB mouth
Solution for lofty: trace YBBBB point BGBBY sooty BGBGG lofty
Solution for youth: trace YBBBB point BGBBY sooty BGBGY youth
Solution for hotly: trace YBBBB point BGBBY sooty BGBYG hotly
Solution for booth: trace YBBBB point BGBBY sooty BGGGB booth
Solution for booty: trace YBBBB point BGBBY sooty BGGGG booty
Solution for motto: trace YBBBB point BGBBY sooty BGYGB motto
Solution for south: trace YBBBB point BGBBY sooty GGBGB south
Solution for sooth: trace YBBBB point BGBBY sooty GGGGB sooth
Solution for mount: trace YBBBB point BGBGG mount
Solution for donut: trace YBBBB point BGBYG donut
Solution for month: trace YBBBB point BGBYY month
Solution for joist: trace YBBBB point BGGBG humfs BBBBY joist
Solution for foist: trace YBBBB point BGGBG humfs BBBYY foist
Solution for moist: trace YBBBB point BGGBG humfs BBYBY moist
Solution for hoist: trace YBBBB point BGGBG humfs GBBBY hoist
Solution for joint: trace YBBBB point BGGGG joint
Solution for vomit: trace YBBBB point BGYBG vomit
Solution for motif: trace YBBBB point BGYBY motif
Solution for stout: trace YBBBB point BYBBG stout
Solution for flout: trace YBBBB point BYBBG stout BBGGG flout
Solution for ought: trace YBBBB point BYBBG stout BBYYG ought
Solution for shoot: trace YBBBB point BYBBG stout GBGBG shoot
Solution for shout: trace YBBBB point BYBBG stout GBGGG shout
Solution for ghost: trace YBBBB point BYBBG stout YBGBG ghost
Solution for stood: trace YBBBB point BYBBY stood
Solution for quoth: trace YBBBB point BYBBY stood BYGBB quoth
Solution for outgo: trace YBBBB point BYBBY stood BYYYB outgo
Solution for outdo: trace YBBBB point BYBBY stood BYYYY outdo
Solution for stool: trace YBBBB point BYBBY stood GGGGB stool
Solution for sloth: trace YBBBB point BYBBY stood GYGBB sloth
Solution for gusto: trace YBBBB point BYBBY stood YYYBB gusto
Solution for stony: trace YBBBB point BYBGY stony
Solution for snout: trace YBBBB point BYBYG snout
Solution for junto: trace YBBBB point BYBYY junto
Solution for idiot: trace YBBBB point BYGBG idiot
Solution for bigot: trace YBBBB point BYYBG bigot
Solution for ditto: trace YBBBB point BYYBY ditto
Solution for ingot: trace YBBBB point BYYYG ingot
Solution for putty: trace YBBBB point GBBBY putty
Solution for pithy: trace YBBBB point GBYBY pithy
Solution for pouty: trace YBBBB point GGBBY pouty
Solution for posit: trace YBBBB point GGYBG posit
Solution for photo: trace YBBBB point GYBBY photo
Solution for pivot: trace YBBBB point GYYBG pivot
Solution for pilot: trace YBBBB point GYYBG pivot GGBGG pilot
Solution for pinto: trace YBBBB point GYYYY pinto
Solution for stump: trace YBBBB point YBBBY stump
Solution for spilt: trace YBBBB point YBGBG spilt
Solution for split: trace YBBBB point YBYBG split
Solution for input: trace YBBBB point YBYYG input
Solution for spout: trace YBBBB point YYBBG spout
Solution for stoop: trace YBBBB point YYBBY stoop
Solution for stomp: trace YBBBB point YYBBY stoop GGGBG stomp
Solution for stove: trace YBBBG muils BBBBY zonks BYBBY stove
Solution for stoke: trace YBBBG muils BBBBY zonks BYBGY stoke
Solution for stone: trace YBBBG muils BBBBY zonks BYYBY stone
Solution for style: trace YBBBG muils BBBGY style
Solution for stole: trace YBBBG muils BBBGY style GGBGG stole
Solution for white: trace YBBBG muils BBGBB white
Solution for spite: trace YBBBG muils BBGBY spite
Solution for elite: trace YBBBG muils BBGYB elite
Solution for lithe: trace YBBBG muils BBYYB lithe
Solution for quote: trace YBBBG muils BGBBB quote
Solution for butte: trace YBBBG muils BGBBB quote BGBGG butte
Solution for quite: trace YBBBG muils BGGBB quite
Solution for suite: trace YBBBG muils BGGBY suite
Solution for etude: trace YBBBG muils BYBBB etude
Solution for flute: trace YBBBG muils BYBYB flute
Solution for unite: trace YBBBG muils BYGBB unite
Solution for utile: trace YBBBG muils BYGGB utile
Solution for untie: trace YBBBG muils BYYBB untie
Solution for smote: trace YBBBG muils YBBBY smote
Solution for smite: trace YBBBG muils YBGBY smite
Solution for quest: trace YBBBY peels BBGBY quest
Solution for stein: trace YBBBY peels BBGBY quest BBGYY stein
Solution for guest: trace YBBBY peels BBGBY quest BGGGG guest
Solution for knelt: trace YBBBY peels BBGGB knelt
Solution for dwelt: trace YBBBY peels BBGGB knelt BBGGG dwelt
Solution for smelt: trace YBBBY peels BBGGY smelt
Solution for fetid: trace YBBBY peels BGBBB fetid
Solution for jetty: trace YBBBY peels BGBBB fetid BGGBB jetty
Solution for detox: trace YBBBY peels BGBBB fetid BGGBY detox
Solution for debut: trace YBBBY peels BGBBB fetid BGYBY debut
Solution for debit: trace YBBBY peels BGBBB fetid BGYGY debit
Solution for deity: trace YBBBY peels BGBBB fetid BGYYY deity
Solution for hefty: trace YBBBY peels BGBBB fetid YGYBB hefty
Solution for befit: trace YBBBY peels BGBBB fetid YGYGB befit
Solution for fetus: trace YBBBY peels BGBBG fetus
Solution for zesty: trace YBBBY peels BGBBY zesty
Solution for heist: trace YBBBY peels BGBBY zesty BGYYB heist
Solution for lefty: trace YBBBY peels BGBYB lefty
Solution for beget: trace YBBBY peels BGYBB beget
Solution for beset: trace YBBBY peels BGYBY beset
Solution for betel: trace YBBBY peels BGYYB betel
Solution for quiet: trace YBBBY peels BYBBB quiet
Solution for often: trace YBBBY peels BYBBB quiet BBBGY often
Solution for eight: trace YBBBY peels BYBBB quiet BBYYG eight
Solution for duvet: trace YBBBY peels BYBBB quiet BGBGG duvet
Solution for unmet: trace YBBBY peels BYBBB quiet BYBGG unmet
Solution for ethos: trace YBBBY peels BYBBG ethos
Solution for unset: trace YBBBY peels BYBBY unset
Solution for exist: trace YBBBY peels BYBBY unset BBYYG exist
Solution for onset: trace YBBBY peels BYBBY unset BGGGG onset
Solution for exult: trace YBBBY peels BYBGB exult
Solution for filet: trace YBBBY peels BYBYB womyn BBBBB filet
Solution for inlet: trace YBBBY peels BYBYB womyn BBBBY inlet
Solution for hotel: trace YBBBY peels BYBYB womyn BGBBB hotel
Solution for motel: trace YBBBY peels BYBYB womyn BGYBB motel
Solution for extol: trace YBBBY peels BYBYB womyn BYBBB extol
Solution for islet: trace YBBBY peels BYBYY islet
Solution for event: trace YBBBY peels BYGBB event
Solution for sweet: trace YBBBY peels BYGBY sweet
Solution for sheet: trace YBBBY peels BYGBY sweet GBGGG sheet
Solution for steed: trace YBBBY peels BYGBY sweet GBGGY steed
Solution for fleet: trace YBBBY peels BYGYB fleet
Solution for steel: trace YBBBY peels BYGYY steel
Solution for sleet: trace YBBBY peels BYGYY steel GYGGY sleet
Solution for piety: trace YBBBY peels GBGBB piety
Solution for petty: trace YBBBY peels GGBBB petty
Solution for pesto: trace YBBBY peels GGBBY pesto
Solution for inept: trace YBBBY peels YBGBB inept
Solution for swept: trace YBBBY peels YBGBY swept
Solution for spent: trace YBBBY peels YBGBY swept GBGYG spent
Solution for spelt: trace YBBBY peels YBGGY spelt
Solution for slept: trace YBBBY peels YBGYY slept
Solution for depth: trace YBBBY peels YGBBB depth
Solution for depot: trace YBBBY peels YGBBB depth GGGYB depot
Solution for setup: trace YBBBY peels YGBBY setup
Solution for empty: trace YBBBY peels YYBBB empty
Solution for upset: trace YBBBY peels YYBBY upset
Solution for steep: trace YBBBY peels YYGBY steep
Solution for stick: trace YBBGB hound BBBBB stick
Solution for stuck: trace YBBGB hound BBGBB stuck
Solution for stock: trace YBBGB hound BYBBB stock
Solution for hitch: trace YBBGB hound GBBBB hitch
Solution for hutch: trace YBBGB hound GBYBB hutch
Solution for witch: trace YBBGB hound YBBBB witch
Solution for pitch: trace YBBGB hound YBBBB witch BGGGG pitch
Solution for ditch: trace YBBGB hound YBBBY ditch
Solution for butch: trace YBBGB hound YBYBB butch
Solution for dutch: trace YBBGB hound YBYBY dutch
Solution for botch: trace YBBGB hound YGBBB botch
Solution for notch: trace YBBGB hound YGBYB notch
Solution for eject: trace YBBGY yield BBGBB eject
Solution for elect: trace YBBGY yield BBGYB elect
Solution for fetch: trace YBBGY yield BBYBB fetch
Solution for evict: trace YBBGY yield BYYBB evict
Solution for edict: trace YBBGY yield BYYBY edict
Solution for scout: trace YBBYB scout
Solution for itchy: trace YBBYB scout BYBBY itchy
Solution for uncut: trace YBBYB scout BYBGG uncut
Solution for cloth: trace YBBYB scout BYGBY cloth
Solution for clout: trace YBBYB scout BYGGG clout
Solution for optic: trace YBBYB scout BYYBY optic
Solution for count: trace YBBYB scout BYYYG count
Solution for stoic: trace YBBYB scout GYGBY stoic
Solution for cutie: trace YBBYG cutie
Solution for chute: trace YBBYG cutie GYYBG chute
Solution for cleft: trace YBBYY zoism BBBBB cleft
Solution for chest: trace YBBYY zoism BBBGB chest
Solution for scent: trace YBBYY zoism BBBYB scent
Solution for ethic: trace YBBYY zoism BBYBB ethic
Solution for covet: trace YBBYY zoism BGBBB covet
Solution for comet: trace YBBYY zoism BGBBY comet
Solution for octet: trace YBBYY zoism BYBBB octet
Solution for adapt: trace YBGBB slink BBBBB adapt
Solution for await: trace YBGBB slink BBYBB await
Solution for giant: trace YBGBB slink BBYGB giant
Solution for plant: trace YBGBB slink BGBGB plant
Solution for plait: trace YBGBB slink BGYBB plait
Solution for loath: trace YBGBB slink BYBBB loath
Solution for staff: trace YBGBB slink GBBBB whups BBBBY staff
Solution for stamp: trace YBGBB slink GBBBB whups BBBYY stamp
Solution for shaft: trace YBGBB slink GBBBB whups BGBBY shaft
Solution for stash: trace YBGBB slink GBBBB whups BYBBY stash
Solution for swath: trace YBGBB slink GBBBB whups YYBBY swath
Solution for stand: trace YBGBB slink GBBGB stand
Solution for stank: trace YBGBB slink GBBGG stank
Solution for staid: trace YBGBB slink GBYBB staid
Solution for stain: trace YBGBB slink GBYYB stain
Solution for slant: trace YBGBB slink GGBGB slant
Solution for stall: trace YBGBB slink GYBBB stall
Solution for shalt: trace YBGBB slink GYBBB stall GYGGB shalt
Solution for stalk: trace YBGBB slink GYBBG stalk
Solution for boast: trace YBGBB slink YBBBB boast
Solution for blast: trace YBGBB slink YGBBB blast
Solution for abate: trace YBGBG vlogs BBBBB abate
Solution for state: trace YBGBG vlogs BBBBY state
Solution for skate: trace YBGBG vlogs BBBBY state GBGGG skate
Solution for stake: trace YBGBG vlogs BBBBY state GGGBG stake
Solution for stage: trace YBGBG vlogs BBBGY stage
Solution for agate: trace YBGBG vlogs BBBYB agate
Solution for plate: trace YBGBG vlogs BGBBB plate
Solution for elate: trace YBGBG vlogs BGBBB plate BGGGG elate
Solution for slate: trace YBGBG vlogs BGBBY slate
Solution for stale: trace YBGBG vlogs BYBBY stale
Solution for stave: trace YBGBG vlogs YBBBY stave
Solution for ovate: trace YBGBG vlogs YBYBB ovate
Solution for heath: trace YBGBY sonly BBBBB heath
Solution for death: trace YBGBY sonly BBBBB heath BGGGG death
Solution for meaty: trace YBGBY sonly BBBBG meaty
Solution for exalt: trace YBGBY sonly BBBGB exalt
Solution for dealt: trace YBGBY sonly BBBGB exalt YBGGG dealt
Solution for leapt: trace YBGBY sonly BBBYB leapt
Solution for meant: trace YBGBY sonly BBYBB meant
Solution for leant: trace YBGBY sonly BBYYB leant
Solution for feast: trace YBGBY sonly YBBBB feast
Solution for beast: trace YBGBY sonly YBBBB feast BGGGG beast
Solution for yeast: trace YBGBY sonly YBBBY yeast
Solution for least: trace YBGBY sonly YBBYB least
Solution for stack: trace YBGGB stack
Solution for exact: trace YBGGY exact
Solution for enact: trace YBGGY exact GBGGG enact
Solution for scant: trace YBGYB scant
Solution for chant: trace YBGYB scant BYGGG chant
Solution for coast: trace YBGYB scant YYGBG coast
Solution for aloft: trace YBYBB spiny BBBBB aloft
Solution for about: trace YBYBB spiny BBBBB aloft GBGBG about
Solution for afoot: trace YBYBB spiny BBBBB aloft GBGYG afoot
Solution for abbot: trace YBYBB spiny BBBBB aloft GBYBG abbot
Solution for allot: trace YBYBB spiny BBBBB aloft GGYBG allot
Solution for adult: trace YBYBB spiny BBBBB aloft GYBBG adult
Solution for atoll: trace YBYBB spiny BBBBB aloft GYGBY atoll
Solution for gamut: trace YBYBB spiny BBBBB aloft YBBBG gamut
Solution for datum: trace YBYBB spiny BBBBB aloft YBBBY datum
Solution for quota: trace YBYBB spiny BBBBB aloft YBGBY quota
Solution for gloat: trace YBYBB spiny BBBBB aloft YGGBG gloat
Solution for bloat: trace YBYBB spiny BBBBB aloft YGGBG gloat BGGGG bloat
Solution for float: trace YBYBB spiny BBBBB aloft YGGYG float
Solution for vault: trace YBYBB spiny BBBBB aloft YYBBG vault
Solution for waltz: trace YBYBB spiny BBBBB aloft YYBBY waltz
Solution for fault: trace YBYBB spiny BBBBB aloft YYBYG fault
Solution for fatal: trace YBYBB spiny BBBBB aloft YYBYY fatal
Solution for fatty: trace YBYBB spiny BBBBG fatty
Solution for batty: trace YBYBB spiny BBBBG fatty BGGGG batty
Solution for jaunt: trace YBYBB spiny BBBGB vughy BYBBB jaunt
Solution for daunt: trace YBYBB spiny BBBGB vughy BYBBB jaunt BGGGG daunt
Solution for haunt: trace YBYBB spiny BBBGB vughy BYBYB haunt
Solution for gaunt: trace YBYBB spiny BBBGB vughy BYYBB gaunt
Solution for vaunt: trace YBYBB spiny BBBGB vughy GYBBB vaunt
Solution for natal: trace YBYBB spiny BBBYB natal
Solution for baton: trace YBYBB spiny BBBYB natal YGGBB baton
Solution for junta: trace YBYBB spiny BBBYB natal YYYBB junta
Solution for aunty: trace YBYBB spiny BBBYG aunty
Solution for faith: trace YBYBB spiny BBGBB faith
Solution for amity: trace YBYBB spiny BBGBG amity
Solution for faint: trace YBYBB spiny BBGGB faint
Solution for audit: trace YBYBB spiny BBYBB audit
Solution for admit: trace YBYBB spiny BBYBB audit GBYGG admit
Solution for habit: trace YBYBB spiny BBYBB audit YBBGG habit
Solution for vital: trace YBYBB spiny BBYBB audit YBBYY vital
Solution for aptly: trace YBYBB spiny BGBBG aptly
Solution for adopt: trace YBYBB spiny BYBBB adopt
Solution for patty: trace YBYBB spiny BYBBG patty
Solution for paint: trace YBYBB spiny BYGGB paint
Solution for patio: trace YBYBB spiny BYYBB patio
Solution for squat: trace YBYBB spiny GBBBB squat
Solution for salty: trace YBYBB spiny GBBBG salty
Solution for saint: trace YBYBB spiny GBGGB saint
Solution for satin: trace YBYBB spiny GBYYB satin
Solution for splat: trace YBYBB spiny GGBBB splat
Solution for hasty: trace YBYBB spiny YBBBG hasty
Solution for angst: trace YBYBB spiny YBBYB angst
Solution for nasty: trace YBYBB spiny YBBYG nasty
Solution for waist: trace YBYBB spiny YBGBB waist
Solution for vista: trace YBYBB spiny YBYBB vista
Solution for pasta: trace YBYBB spiny YYBBB pasta
Solution for patsy: trace YBYBB spiny YYBBG patsy
Solution for pasty: trace YBYBB spiny YYBBG patsy GGYYG pasty
Solution for atone: trace YBYBG sulph BBBBB atone
Solution for bathe: trace YBYBG sulph BBBBY bathe
Solution for latte: trace YBYBG sulph BBYBB latte
Solution for lathe: trace YBYBG sulph BBYBY lathe
Solution for haute: trace YBYBG sulph BYBBY haute
Solution for saute: trace YBYBG sulph GYBBB saute
Solution for waste: trace YBYBG sulph YBBBB waste
Solution for baste: trace YBYBG sulph YBBBB waste BGGGG baste
Solution for haste: trace YBYBG sulph YBBBY haste
Solution for paste: trace YBYBG sulph YBBYB paste
Solution for pleat: trace YBYBY pleat
Solution for wheat: trace YBYBY pleat BBGGG wheat
Solution for sweat: trace YBYBY pleat BBGGG wheat YBGGG sweat
Solution for steam: trace YBYBY pleat BBGGY yuked BBBYB steam
Solution for stead: trace YBYBY pleat BBGGY yuked BBBYG stead
Solution for steak: trace YBYBY pleat BBGGY yuked BBYYB steak
Solution for agent: trace YBYBY pleat BBGYG agent
Solution for begat: trace YBYBY pleat BBYGG begat
Solution for asset: trace YBYBY pleat BBYYG asset
Solution for matey: trace YBYBY pleat BBYYY matey
Solution for eaten: trace YBYBY pleat BBYYY matey BGGGB eaten
Solution for bleat: trace YBYBY pleat BGGGG bleat
Solution for steal: trace YBYBY pleat BYGGY steal
Solution for metal: trace YBYBY pleat BYYGY metal
Solution for fetal: trace YBYBY pleat BYYGY metal BGGGG fetal
Solution for valet: trace YBYBY pleat BYYYG valet
Solution for delta: trace YBYBY pleat BYYYY delta
Solution for petal: trace YBYBY pleat GYYGY petal
Solution for adept: trace YBYBY pleat YBGYG adept
Solution for hatch: trace YBYGB plumb BBBBB wicca BBBGY hatch
Solution for catch: trace YBYGB plumb BBBBB wicca BBYGY catch
Solution for watch: trace YBYGB plumb BBBBB wicca GBBGY watch
Solution for batch: trace YBYGB plumb BBBBY batch
Solution for match: trace YBYGB plumb BBBYB match
Solution for latch: trace YBYGB plumb BYBBB latch
Solution for patch: trace YBYGB plumb GBBBB patch
Solution for caput: trace YBYYB yonis BBBBB caput
Solution for attic: trace YBYYB yonis BBBGB attic
Solution for cacti: trace YBYYB yonis BBBYB cacti
Solution for antic: trace YBYYB yonis BBYGB antic
Solution for octal: trace YBYYB yonis BYBBB octal
Solution for ascot: trace YBYYB yonis BYBBY ascot
Solution for yacht: trace YBYYB yonis GBBBB yacht
Solution for catty: trace YBYYB yonis YBBBB catty
Solution for caste: trace YBYYG caste
Solution for acute: trace YBYYG caste YYBGG acute
Solution for cleat: trace YBYYY cleat
Solution for cheat: trace YBYYY cleat GBGGG cheat
Solution for cadet: trace YBYYY cleat GBYYG cadet
Solution for facet: trace YBYYY cleat YBYYG facet
Solution for eclat: trace YBYYY cleat YYYGG eclat
Solution for broth: trace YGBBB unfit BBBBY broth
Solution for orbit: trace YGBBB unfit BBBGG orbit
Solution for droit: trace YGBBB unfit BBBGG orbit YGBGG droit
Solution for wrist: trace YGBBB unfit BBBYG wrist
Solution for frost: trace YGBBB unfit BBYBG frost
Solution for froth: trace YGBBB unfit BBYBY froth
Solution for drift: trace YGBBB unfit BBYYG drift
Solution for fritz: trace YGBBB unfit BBYYY fritz
Solution for print: trace YGBBB unfit BYBYG print
Solution for front: trace YGBBB unfit BYYBG front
Solution for grout: trace YGBBB unfit YBBBG grout
Solution for fruit: trace YGBBB unfit YBYGG fruit
Solution for grunt: trace YGBBB unfit YYBBG grunt
Solution for brunt: trace YGBBB unfit YYBBG grunt BGGGG brunt
Solution for wrote: trace YGBBG wrote
Solution for brute: trace YGBBG wrote BGBGG brute
Solution for write: trace YGBBG wrote GGBGG write
Solution for wrest: trace YGBBY wrest
Solution for greet: trace YGBBY wrest BGGBG greet
Solution for erupt: trace YGBBY wrest BGYBG erupt
Solution for erect: trace YGBGY erect
Solution for crypt: trace YGBYB crypt
Solution for crust: trace YGBYB crypt GGBBG crust
Solution for crest: trace YGBYY crest
Solution for crept: trace YGBYY crest GGGBG crept
Solution for grant: trace YGGBB grant
Solution for draft: trace YGGBB grant BGGBG draft
Solution for wrath: trace YGGBB grant BGGBY wrath
Solution for graft: trace YGGBB grant GGGBG graft
Solution for irate: trace YGGBG irate
Solution for grate: trace YGGBG irate BGGGG grate
Solution for craft: trace YGGYB craft
Solution for crate: trace YGGYG crate
Solution for artsy: trace YGYBB artsy
Solution for great: trace YGYBY great
Solution for flirt: trace YYBBB shout BBBBG flirt
Solution for dirty: trace YYBBB shout BBBBY dirty
Solution for burnt: trace YYBBB shout BBBYG burnt
Solution for blurt: trace YYBBB shout BBBYG burnt GYYBG blurt
Solution for robot: trace YYBBB shout BBYBG robot
Solution for rotor: trace YYBBB shout BBYBY rotor
Solution for motor: trace YYBBB shout BBYBY rotor BGGGG motor
Solution for forty: trace YYBBB shout BBYBY rotor YGYBB forty
Solution for intro: trace YYBBB shout BBYBY rotor YYGBB intro
Solution for right: trace YYBBB shout BYBBG right
Solution for girth: trace YYBBB shout BYBBY zombi BBBBY girth
Solution for birth: trace YYBBB shout BYBBY zombi BBBYY birth
Solution for mirth: trace YYBBB shout BYBBY zombi BBYBY mirth
Solution for forth: trace YYBBB shout BYYBY yewen BBBBB forth
Solution for north: trace YYBBB shout BYYBY yewen BBBBY north
Solution for worth: trace YYBBB shout BYYBY yewen BBYBB worth
Solution for skirt: trace YYBBB shout GBBBG skirt
Solution for strip: trace YYBBB shout GBBBY strip
Solution for strut: trace YYBBB shout GBBGG strut
Solution for spurt: trace YYBBB shout GBBYG spurt
Solution for sport: trace YYBBB shout GBGBG sport
Solution for snort: trace YYBBB shout GBGBG sport GBGGG snort
Solution for stork: trace YYBBB shout GBGBY zymic BBBBB stork
Solution for storm: trace YYBBB shout GBGBY zymic BBYBB storm
Solution for story: trace YYBBB shout GBGBY zymic BYBBB story
Solution for shirt: trace YYBBB shout GGBBG shirt
Solution for short: trace YYBBB shout GGGBG short
Solution for first: trace YYBBB shout YBBBG first
Solution for burst: trace YYBBB shout YBBYG burst
Solution for rusty: trace YYBBB shout YBBYY rusty
Solution for roost: trace YYBBB shout YBGBG roost
Solution for worst: trace YYBBB shout YBYBG worst
Solution for route: trace YYBBG route
Solution for forte: trace YYBBG route YGBGG forte
Solution for store: trace YYBBG route YYBYG store
Solution for outer: trace YYBBY metes BBGGB outer
Solution for inter: trace YYBBY metes BBGGB outer BBGGG inter
Solution for utter: trace YYBBY metes BBGGB outer BYGGG utter
Solution for otter: trace YYBBY metes BBGGB outer GBGGG otter
Solution for voter: trace YYBBY metes BBGGB outer YBGGG voter
Solution for rivet: trace YYBBY metes BBYGB rivet
Solution for other: trace YYBBY metes BBYGB rivet YBBGY other
Solution for retry: trace YYBBY metes BGGBB retry
Solution for retro: trace YYBBY metes BGGBB retry GGGGB retro
Solution for deter: trace YYBBY metes BGGGB deter
Solution for refit: trace YYBBY metes BGYBB refit
Solution for rebut: trace YYBBY metes BGYBB refit GGBBG rebut
Solution for berth: trace YYBBY metes BGYBB refit YGBBY berth
Solution for beret: trace YYBBY metes BGYGB beret
Solution for reset: trace YYBBY metes BGYGY reset
Solution for entry: trace YYBBY metes BYGBB entry
Solution for enter: trace YYBBY metes BYGGB enter
Solution for ester: trace YYBBY metes BYGGY ester
Solution for overt: trace YYBBY metes BYYBB overt
Solution for inert: trace YYBBY metes BYYBB overt BBGGG inert
Solution for stern: trace YYBBY metes BYYBY stern
Solution for ether: trace YYBBY metes BYYGB ether
Solution for egret: trace YYBBY metes BYYGB ether GYBGY egret
Solution for steer: trace YYBBY metes BYYGY steer
Solution for exert: trace YYBBY metes BYYYB exert
Solution for metro: trace YYBBY metes GGGBB metro
Solution for meter: trace YYBBY metes GGGGB meter
Solution for merit: trace YYBBY metes GGYBB merit
Solution for remit: trace YYBBY metes YGYBB remit
Solution for retch: trace YYBGY retch
Solution for court: trace YYBYB court
Solution for recut: trace YYBYY recut
Solution for apart: trace YYGBB sturt BBBGG apart
Solution for quart: trace YYGBB sturt BBYGG quart
Solution for smart: trace YYGBB sturt GBBGG smart
Solution for stark: trace YYGBB sturt GGBGB stark
Solution for start: trace YYGBB sturt GGBGG start
Solution for stair: trace YYGBB sturt GGBYB stair
Solution for roast: trace YYGBB sturt YBBYG roast
Solution for stare: trace YYGBG stare
Solution for heart: trace YYGBY heart
Solution for react: trace YYGGY react
Solution for chart: trace YYGYB chart
Solution for ultra: trace YYYBB worry BBBGB ultra
Solution for strap: trace YYYBB worry BBGBB strap
Solution for stray: trace YYYBB worry BBGBG stray
Solution for party: trace YYYBB worry BBGBG stray BYGYG party
Solution for altar: trace YYYBB worry BBYBB altar
Solution for ratty: trace YYYBB worry BBYBG ratty
Solution for satyr: trace YYYBB worry BBYBY satyr
Solution for aorta: trace YYYBB worry BGGBB aorta
Solution for abort: trace YYYBB worry BYBGB abort
Solution for ratio: trace YYYBB worry BYYBB ratio
Solution for warty: trace YYYBB worry GBGBG warty
Solution for straw: trace YYYBB worry YBGBB straw
Solution for after: trace YYYBY wheel BBBGB after
Solution for later: trace YYYBY wheel BBBGY later
Solution for alter: trace YYYBY wheel BBBGY later YYGGG alter
Solution for avert: trace YYYBY wheel BBGBB avert
Solution for alert: trace YYYBY wheel BBGBY alert
Solution for extra: trace YYYBY wheel BBYBB extra
Solution for eater: trace YYYBY wheel BBYGB eater
Solution for hater: trace YYYBY wheel BYBGB hater
Solution for earth: trace YYYBY wheel BYYBB earth
Solution for water: trace YYYBY wheel GBBGB water
Solution for carat: trace YYYYB carat
Solution for actor: trace YYYYB carat YYYBY actor
Solution for cater: trace YYYYY cater

=== Solver Statistics ===
Total answers: 2309
Total solved: 2309 (100.00%)
Average depth: 3.43

Solved by depth:
Depth | Count  | % of Total | % of Solved | Cumul. %
------|--------|------------|-------------|----------
    1 |      1 |      0.04% |       0.04% |    0.04%
    2 |     75 |      3.25% |       3.25% |    3.29%
    3 |   1234 |     53.44% |      53.44% |   56.73%
    4 |    922 |     39.93% |      39.93% |   96.67%
    5 |     76 |      3.29% |       3.29% |   99.96%
    6 |      1 |      0.04% |       0.04% |  100.00%
==================================================

